birim,isim,arastirma_alan,proje,yayin,ders,toplam,
Atatürk İlkeleri ve İnkılap Tarihi,Fahriye Dinçer,0,0,22,13,35,
Atatürk İlkeleri ve İnkılap Tarihi,Mehmet Beşikçi,5,3,24,1,33,
Atatürk İlkeleri ve İnkılap Tarihi,Ercan Karakoç,0,0,19,4,23,
Atatürk İlkeleri ve İnkılap Tarihi,Eray Yılmaz,5,0,13,1,19,
Atatürk İlkeleri ve İnkılap Tarihi,Zafer Doğan,2,0,6,0,8,
Atatürk İlkeleri ve İnkılap Tarihi,Gülsema Lüyer,5,0,0,1,6,
Atatürk İlkeleri ve İnkılap Tarihi,Neslihan ERKAN,2,0,0,2,4,
Batı Dilleri ve Edebiyatı,Ertuğrul Efeoğlu,12,0,180,0,192,
Batı Dilleri ve Edebiyatı,Ayşe Banu KARADAĞ,5,1,107,68,181,
Batı Dilleri ve Edebiyatı,Lale Özcan,7,1,41,4,53,
Batı Dilleri ve Edebiyatı,Sündüz Kasar,0,0,45,5,50,
Batı Dilleri ve Edebiyatı,Sadriye Güneş,0,7,33,6,46,
Batı Dilleri ve Edebiyatı,Emine BOGENÇ DEMİREL,0,5,38,1,44,
Batı Dilleri ve Edebiyatı,SERHAT ULAĞLI,1,0,32,9,42,
Batı Dilleri ve Edebiyatı,Pınar Güzelyürek Çelik,0,1,30,1,32,
Batı Dilleri ve Edebiyatı,Özgür Elif Ertan,0,0,29,1,30,
Batı Dilleri ve Edebiyatı,anna lia ergun,0,3,25,0,28,
Batı Dilleri ve Edebiyatı,Hülya Yılmaz,1,0,21,4,26,
Batı Dilleri ve Edebiyatı,Duygu (Çurum) DUMAN,5,1,16,2,24,
Batı Dilleri ve Edebiyatı,Semra Baturay,4,2,15,2,23,
Batı Dilleri ve Edebiyatı,Beki Haleva,0,1,14,7,22,
Batı Dilleri ve Edebiyatı,Şule Demirkol-Ertürk,0,2,20,0,22,
Batı Dilleri ve Edebiyatı,Deniz Koçak Kurmel,3,1,9,2,15,
Batı Dilleri ve Edebiyatı,Hande Ersöz Demirdağ,2,2,6,2,12,
Batı Dilleri ve Edebiyatı,FÜSUN BİLİR ATASEVEN,0,1,8,2,11,
Batı Dilleri ve Edebiyatı,Zeynep Görgüler,3,0,6,0,9,
Batı Dilleri ve Edebiyatı,Ayşe Ayhan,2,0,2,0,4,
Beden Eğitimi,Çetin Erdem SONAL,3,0,1,5,9,
Beden Eğitimi,Şener GÜNAY,0,0,1,0,1,
Bilgisayar Mühendisliği,Banu Diri,2,7,89,4,102,
Bilgisayar Mühendisliği,Ferkan YILMAZ,20,0,75,0,95,
Bilgisayar Mühendisliği,Gökhan Bilgin,9,7,55,4,75,
Bilgisayar Mühendisliği,Mehmet Aktaş,13,12,43,0,68,
Bilgisayar Mühendisliği,SIRMA YAVUZ,3,7,50,4,64,
Bilgisayar Mühendisliği,Songül Varlı Albayrak,0,4,48,1,53,
Bilgisayar Mühendisliği,M. Fatih Amasyalı,4,2,41,1,48,
Bilgisayar Mühendisliği,Göksel Biricik,5,6,22,14,47,
Bilgisayar Mühendisliği,Nizamettin AYDIN,0,1,46,0,47,
Bilgisayar Mühendisliği,Erkan Uslu,0,9,20,8,37,
Bilgisayar Mühendisliği,Zeyneb Kurt,6,2,28,0,36,
Bilgisayar Mühendisliği,M. Amaç Güvensan,6,4,20,0,30,
Bilgisayar Mühendisliği,OĞUZ ALTUN,3,2,20,1,26,
Bilgisayar Mühendisliği,Ziya Cihan Taysi,5,4,16,0,25,
Bilgisayar Mühendisliği,Furkan Çakmak,5,4,16,0,25,
Bilgisayar Mühendisliği,Ömer Özgür Bozkurt,3,4,8,7,22,
Bilgisayar Mühendisliği,Veli Hakkoymaz,0,0,13,8,21,
Bilgisayar Mühendisliği,Uğur ÇEKMEZ,6,3,9,0,18,
Bilgisayar Mühendisliği,Sercan Aygün,5,1,12,0,18,
Bilgisayar Mühendisliği,Ahmet Tevfik İNAN,3,0,4,10,17,
Bilgisayar Mühendisliği,Hafiza İrem TÜRKMEN,0,1,15,0,16,
Bilgisayar Mühendisliği,Yunus Emre Selçuk,2,1,8,3,14,
Bilgisayar Mühendisliği,hamza osman ilhan,0,2,12,0,14,
Bilgisayar Mühendisliği,ismail duru,5,4,5,0,14,
Bilgisayar Mühendisliği,İbrahim Onur Sığırcı,7,1,6,0,14,
Bilgisayar Mühendisliği,AHMET ELBİR,5,1,7,0,13,
Bilgisayar Mühendisliği,Ali Yamuç,9,0,3,0,12,
Bilgisayar Mühendisliği,Nihal ALTUNTAŞ,3,2,6,0,11,
Bilgisayar Mühendisliği,Abdülkadir ALBAYRAK,6,1,4,0,11,
Bilgisayar Mühendisliği,Asım Kasapoğlu,0,0,7,3,10,
Bilgisayar Mühendisliği,Ozan Özışık,0,2,7,0,9,
Bilgisayar Mühendisliği,GÜRKAN ALPASLAN,2,0,7,0,9,
Bilgisayar Mühendisliği,GÜRKAN ŞAHİN,1,1,7,0,9,
Bilgisayar Mühendisliği,A. Gökhan YAVUZ,0,1,7,0,8,
Bilgisayar Mühendisliği,OYA KALIPSIZ,0,0,4,2,6,
Bilgisayar Mühendisliği,Kamil Erdayandı,0,1,5,0,6,
Bilgisayar Mühendisliği,Adem Güçlü,0,0,5,0,5,
Bilgisayar Mühendisliği,Zeynep Banu Özger,0,0,5,0,5,
Bilgisayar Mühendisliği,Ahmet Coşkun Sönmez,0,0,5,0,5,
Bilgisayar Mühendisliği,Fatih KELEŞ,0,1,3,0,4,
Bilgisayar Mühendisliği,Tülin Sarı,0,0,4,0,4,
Bilgisayar Mühendisliği,Aysun Sezer,3,0,1,0,4,
Bilgisayar Mühendisliği,mecit yüzkat,3,0,1,0,4,
Bilgisayar Mühendisliği,Mustafa Utku Kalay,0,0,2,1,3,
Bilgisayar Mühendisliği,Hacer Bayıroğlu,0,0,2,0,2,
Bilgisayar Mühendisliği,Uğur Ergül,0,0,1,0,1,
Bilgisayar Mühendisliği,M. Said Aydemir,0,0,1,0,1,
Bilgisayar Mühendisliği,Mine Elif Karsligil,0,0,1,0,1,
Bilgisayar Mühendisliği,Ahmet DEVELİ,0,0,1,0,1,
Bilgisayar ve Öğretim Teknolojileri Eğitimi,Feza Orhan,0,3,44,10,57,
Bilgisayar ve Öğretim Teknolojileri Eğitimi,Tuncay Sevindik,3,2,32,8,45,
Bilgisayar ve Öğretim Teknolojileri Eğitimi,Mehmet Fatih ERKOÇ,1,4,34,0,39,
Bilgisayar ve Öğretim Teknolojileri Eğitimi,Sabiha AKGÜN YENİ,4,6,20,7,37,
Bilgisayar ve Öğretim Teknolojileri Eğitimi,M. Betül Yılmaz,0,4,18,13,35,
Bilgisayar ve Öğretim Teknolojileri Eğitimi,Beyza Bayrak,0,1,28,6,35,
Bilgisayar ve Öğretim Teknolojileri Eğitimi,Selda Kayak,0,1,27,0,28,
Bilgisayar ve Öğretim Teknolojileri Eğitimi,Tuba Uğraş,6,3,18,0,27,
Bilgisayar ve Öğretim Teknolojileri Eğitimi,Zeynep Gecü-Parmaksız,0,2,18,0,20,
Bilgisayar ve Öğretim Teknolojileri Eğitimi,Ayşe Günay Gökben,0,2,15,0,17,
Bilgisayar ve Öğretim Teknolojileri Eğitimi,Melike KAVUK KALENDER,2,0,14,0,16,
Bilgisayar ve Öğretim Teknolojileri Eğitimi,Serhat Bahadır Kert,0,2,13,0,15,
Bilgisayar ve Öğretim Teknolojileri Eğitimi,Çiğdem Uz Bilgin,0,1,12,0,13,
Bilgisayar ve Öğretim Teknolojileri Eğitimi,Meryem Köşkeroğlu Büyükimdat,0,2,9,0,11,
Bilgisayar ve Öğretim Teknolojileri Eğitimi,Gülüstan Doğan,0,0,11,0,11,
Bilgisayar ve Öğretim Teknolojileri Eğitimi,Emre Özgündüz,0,0,4,0,4,
Biyomedikal Mühendisliği,Görkem Serbes,0,1,34,11,46,
Biyomedikal Mühendisliği,Kamuran Kadıpaşaoğlu,6,0,1,10,17,
Biyomedikal Mühendisliği,Özcan Tunçtürk,0,0,0,1,1,
Biyomühendislik,Adil Allahverdiyev,10,21,198,14,243,
Biyomühendislik,Zeynep Akdeste,0,10,198,2,210,
Biyomühendislik,Sevil Yücel,8,25,121,14,168,
Biyomühendislik,Didem Özçimen,6,22,115,14,157,
Biyomühendislik,MELAHAT BAĞIROVA,6,22,100,15,143,
Biyomühendislik,Dilek Turgut Balık,12,16,102,0,130,
Biyomühendislik,İbrahim Işıldak,0,55,70,0,125,
Biyomühendislik,Rabia Çakır Koç,3,8,67,24,102,
Biyomühendislik,Cem Bülent Üstündağ,6,12,58,10,86,
Biyomühendislik,Muhammet U. Kahveci,7,8,66,4,85,
Biyomühendislik,YASEMİN KILINÇ,0,18,55,0,73,
Biyomühendislik,Musa Türker,3,7,62,1,73,
Biyomühendislik,Serap DERMAN,4,13,44,0,61,
Biyomühendislik,Yeliz Elalmış,3,10,41,4,58,
Biyomühendislik,Mehmet Burçin Pişkin,0,10,47,0,57,
Biyomühendislik,Esma Ahlatcıoğlu Özerol,4,3,39,3,49,
Biyomühendislik,M. Murat Özmen,7,4,29,9,49,
Biyomühendislik,Azade Attar,3,7,33,0,43,
Biyomühendislik,Alper Yilmaz,5,2,18,17,42,
Biyomühendislik,Ayhan Bingölbali,0,11,26,0,37,
Biyomühendislik,Kadriye Kızılbey,0,5,31,0,36,
Biyomühendislik,Emrah Şefik Abamor,0,3,31,0,34,
Biyomühendislik,Ayşegül Erdemir,6,3,25,0,34,
Biyomühendislik,Gündoğ Yücesan,1,11,20,0,32,
Biyomühendislik,Zafer Ömer ÖZDEMİR,0,1,24,0,25,
Biyomühendislik,Murat Topuzoğulları,3,4,18,0,25,
Biyomühendislik,Emrah SARIYER,7,2,13,2,24,
Biyomühendislik,Sezen Canım Ateş,0,8,15,0,23,
Biyomühendislik,Tuğba Özer,3,3,9,0,15,
Biyomühendislik,Rıdvan Yıldırım,5,6,0,2,13,
Biyomühendislik,Muhammet Çelik,3,1,0,5,9,
Biyomühendislik,Azime Yilmaz,0,1,3,0,4,
Biyomühendislik,Mustafa Niğde,0,2,0,0,2,
Elektrik - Elektronik Fakültesi,Erdin GÖKALP,1,1,3,4,9,
Elektrik - Elektronik Fakültesi,M. Salih Taci,0,0,8,0,8,
Elektrik - Elektronik Fakültesi,A. Hülya OBDAN,0,3,4,0,7,
Elektrik - Elektronik Fakültesi,Kadir Doğanşahin,4,0,0,0,4,
Elektrik - Elektronik Fakültesi,Ayşe Bilge Gündüz,1,0,1,0,2,
Elektrik - Elektronik Fakültesi,Nihat Akkan,0,0,1,0,1,
Elektrik Mühendisliği,Bora ACARKAN,27,7,24,55,113,
Elektrik Mühendisliği,Ozan Erdinç,2,8,66,4,80,
Elektrik Mühendisliği,Hacı BODUR,5,9,56,7,77,
Elektrik Mühendisliği,Uğur Savaş Selamoğulları,3,8,37,10,58,
Elektrik Mühendisliği,Ahmet Faruk Bakan,1,11,45,1,58,
Elektrik Mühendisliği,Aslan İnan,2,3,37,12,54,
Elektrik Mühendisliği,İbrahim Şenol,0,9,42,1,52,
Elektrik Mühendisliği,Bedri Kekezoğlu,5,8,35,4,52,
Elektrik Mühendisliği,Ali Rıfat Boynueğri,10,12,29,0,51,
Elektrik Mühendisliği,Naim Süleyman TINĞ,9,0,24,5,38,
Elektrik Mühendisliği,ONUR ELMA,5,5,23,1,34,
Elektrik Mühendisliği,Mustafa BAYSAL,0,5,22,7,34,
Elektrik Mühendisliği,Akın Taşcıkaraoğlu,4,7,23,0,34,
Elektrik Mühendisliği,Engin AYÇİÇEK,4,7,23,0,34,
Elektrik Mühendisliği,YUSUF YAŞA,7,4,21,0,32,
Elektrik Mühendisliği,Hakan AKÇA,3,5,21,2,31,
Elektrik Mühendisliği,Ali Durusu,2,3,26,0,31,
Elektrik Mühendisliği,BURAK AKIN,3,3,24,1,31,
Elektrik Mühendisliği,Selin Özçıra,0,6,25,0,31,
Elektrik Mühendisliği,M. Hadi Sarul,0,3,25,2,30,
Elektrik Mühendisliği,Yavuz ATEŞ,4,3,12,10,29,
Elektrik Mühendisliği,Yasemin Oner,3,5,20,0,28,
Elektrik Mühendisliği,Altuğ BOZKURT,0,1,22,5,28,
Elektrik Mühendisliği,Nur Bekiroğlu,0,8,18,0,26,
Elektrik Mühendisliği,Oktay ARIKAN,0,3,23,0,26,
Elektrik Mühendisliği,İsmail NAKİR,0,7,16,3,26,
Elektrik Mühendisliği,A. Yiğit ARABUL,5,3,9,6,23,
Elektrik Mühendisliği,Sibel ZORLU PARTAL,0,3,19,0,22,
Elektrik Mühendisliği,Mustafa Gürkan Aydeniz,2,3,9,6,20,
Elektrik Mühendisliği,Ercan İZGİ,6,2,8,3,19,
Elektrik Mühendisliği,Selim TRABULUS,0,0,18,1,19,
Elektrik Mühendisliği,Özgün GİRGİN,1,2,10,6,19,
Elektrik Mühendisliği,BEYHAN KILIÇ,7,0,12,0,19,
Elektrik Mühendisliği,Erkan Meşe,0,2,9,7,18,
Elektrik Mühendisliği,Ramazan AYAZ,2,3,13,0,18,
Elektrik Mühendisliği,Celal Fadıl KUMRU,0,2,14,0,16,
Elektrik Mühendisliği,Ali AJDER,2,0,10,3,15,
Elektrik Mühendisliği,Erdem AKBOY,3,3,7,1,14,
Elektrik Mühendisliği,Enes UGUR,0,3,9,1,13,
Elektrik Mühendisliği,Giray Eşref KIRAL,5,2,5,0,12,
Elektrik Mühendisliği,Murat TEZCAN,0,1,10,0,11,
Elektrik Mühendisliği,İbrahim Şengör,3,2,5,1,11,
Elektrik Mühendisliği,Gürcan YANIK,1,3,6,0,10,
Elektrik Mühendisliği,Nihan ALTINTAŞ,1,2,5,2,10,
Elektrik Mühendisliği,Recep YUMURTACI,0,0,7,3,10,
Elektrik Mühendisliği,Fatma KESKİN ARABUL,3,0,7,0,10,
Elektrik Mühendisliği,Said Mirza Tercan,3,2,3,1,9,
Elektrik Mühendisliği,Hüseyin AKDEMİR,3,0,6,0,9,
Elektrik Mühendisliği,ALi ERDUMAN,0,0,8,0,8,
Elektrik Mühendisliği,Alpaslan Demirci,0,0,0,8,8,
Elektrik Mühendisliği,Hasan Can KILIÇKIRAN,2,1,5,0,8,
Elektrik Mühendisliği,Eyüp Taslak,2,1,5,0,8,
Elektrik Mühendisliği,Ali Ağçal,0,1,7,0,8,
Elektrik Mühendisliği,Hilmi Gürleyen,4,0,3,0,7,
Elektrik Mühendisliği,Ahmet Özdeş,0,0,0,6,6,
Elektrik Mühendisliği,Nurettin Umurkan,0,0,5,0,5,
Elektrik Mühendisliği,Selim AY,0,0,1,3,4,
Elektrik Mühendisliği,Hüseyin ÇAKIR,2,0,1,1,4,
Elektrik Mühendisliği,Yakup ŞAHİN,4,0,0,0,4,
Elektrik Mühendisliği,Adem ÜNAL,0,0,1,2,3,
Elektrik Mühendisliği,Gökhan Satılmış,3,0,0,0,3,
Elektrik Mühendisliği,GÜLDEREN YILDIRMAZ,0,0,0,2,2,
Elektrik Mühendisliği,SADIK ÖZDEMİR,0,1,0,0,1,
Elektrik Mühendisliği,Elektrik Makinaları,0,0,0,1,1,
Elektrik Mühendisliği,Furkan Akar,0,0,1,0,1,
Elektrik Mühendisliği,Sayısal Elektronik ve Mikroişlemciler Lab .,0,0,0,1,1,
Elektronik & Haberleşme Mühendisliği,Ufuk Türeli,0,14,81,9,104,
Elektronik & Haberleşme Mühendisliği,Ahmet Serdar Türk,5,13,73,4,95,
Elektronik & Haberleşme Mühendisliği,Hacı İLHAN,9,6,59,17,91,
Elektronik & Haberleşme Mühendisliği,Nurhan TÜRKER TOKAN,10,6,40,12,68,
Elektronik & Haberleşme Mühendisliği,Filiz GÜNEŞ,9,8,47,2,66,
Elektronik & Haberleşme Mühendisliği,Taner Şengör,12,1,53,0,66,
Elektronik & Haberleşme Mühendisliği,Tansal Güçlüoğlu,6,6,33,16,61,
Elektronik & Haberleşme Mühendisliği,Umut Engin Ayten,0,6,40,8,54,
Elektronik & Haberleşme Mühendisliği,Revna Acar Vural,5,6,30,13,54,
Elektronik & Haberleşme Mühendisliği,Burcu Erkmen,4,8,28,9,49,
Elektronik & Haberleşme Mühendisliği,Nihan Kahraman,6,12,25,5,48,
Elektronik & Haberleşme Mühendisliği,Fikret Tokan,7,5,27,3,42,
Elektronik & Haberleşme Mühendisliği,Lütfiye Durak Ata,4,8,23,6,41,
Elektronik & Haberleşme Mühendisliği,Herman SEDEF,0,0,34,4,38,
Elektronik & Haberleşme Mühendisliği,Ahmet KIZILAY,0,4,28,0,32,
Elektronik & Haberleşme Mühendisliği,Hamidullah Binol,5,3,22,0,30,
Elektronik & Haberleşme Mühendisliği,peyman mahouti,5,0,23,2,30,
Elektronik & Haberleşme Mühendisliği,Hamid Torpi,4,6,12,4,26,
Elektronik & Haberleşme Mühendisliği,Nergis TURAL POLAT,5,0,9,11,25,
Elektronik & Haberleşme Mühendisliği,Hakan Paşa PARTAL,6,10,6,3,25,
Elektronik & Haberleşme Mühendisliği,Ahmet Serbes,0,3,16,4,23,
Elektronik & Haberleşme Mühendisliği,Serkan Kurt,4,2,9,7,22,
Elektronik & Haberleşme Mühendisliği,Alper Çalışkan,2,2,17,0,21,
Elektronik & Haberleşme Mühendisliği,Lale ÖZYILMAZ,3,0,5,9,17,
Elektronik & Haberleşme Mühendisliği,Hüseyin Çukur,5,1,11,0,17,
Elektronik & Haberleşme Mühendisliği,Nerhun Yıldız,0,2,7,7,16,
Elektronik & Haberleşme Mühendisliği,Muhammet Ali KARABULUT,1,2,7,3,13,
Elektronik & Haberleşme Mühendisliği,Zehra Gülru Çam,0,0,11,2,13,
Elektronik & Haberleşme Mühendisliği,Mehmet Nadir Kurnaz,6,0,0,6,12,
Elektronik & Haberleşme Mühendisliği,Mehmet Ali BELEN,0,0,11,0,11,
Elektronik & Haberleşme Mühendisliği,Bülent Bolat,0,6,4,0,10,
Elektronik & Haberleşme Mühendisliği,Oğuzhan Yavuz,0,0,9,0,9,
Elektronik & Haberleşme Mühendisliği,Tülay YILDIRIM,0,1,8,0,9,
Elektronik & Haberleşme Mühendisliği,VEDAT TAVŞANOĞLU,0,2,7,0,9,
Elektronik & Haberleşme Mühendisliği,Mehmet Ünal,0,2,6,0,8,
Elektronik & Haberleşme Mühendisliği,Yunus Emre YAMAÇ,0,0,8,0,8,
Elektronik & Haberleşme Mühendisliği,Murathan Alpay,0,1,2,4,7,
Elektronik & Haberleşme Mühendisliği,Banu ATAŞLAR AYYILDIZ,0,0,0,7,7,
Elektronik & Haberleşme Mühendisliği,Ali Rıza YILMAZ,0,1,5,0,6,
Elektronik & Haberleşme Mühendisliği,Pınar ÖZKAN BAKBAK,4,1,0,0,5,
Elektronik & Haberleşme Mühendisliği,İsmail Cantürk,0,1,4,0,5,
Elektronik & Haberleşme Mühendisliği,Hayri Aslan,1,2,2,0,5,
Elektronik & Haberleşme Mühendisliği,Sibel ÇİMEN,0,0,5,0,5,
Elektronik & Haberleşme Mühendisliği,Nurullah Çalık,0,0,0,4,4,
Elektronik & Haberleşme Mühendisliği,Hüsamettin Uysal,0,0,0,4,4,
Elektronik & Haberleşme Mühendisliği,Özden Niyaz,0,1,2,1,4,
Elektronik & Haberleşme Mühendisliği,Murat TAŞKIRAN,0,0,2,2,4,
Elektronik & Haberleşme Mühendisliği,ARDA GÜNEY,0,0,0,2,2,
Elektronik & Haberleşme Mühendisliği,Ali Görçin,1,0,0,1,2,
Elektronik & Haberleşme Mühendisliği,senem makal,0,0,1,0,1,
Elektronik & Haberleşme Mühendisliği,Onur Can Kurban,0,0,1,0,1,
Elektronik & Haberleşme Mühendisliği,Aktül Kavas,0,0,1,0,1,
Elektronik & Haberleşme Mühendisliği,BURAK AKGÜL,0,0,0,1,1,
Elektronik & Haberleşme Mühendisliği,Hatice Vildan DÜDÜKÇÜ,0,0,0,1,1,
Endüstri Mühendisliği,İhsan Kaya,13,2,151,6,172,
Endüstri Mühendisliği,Selçuk Çebi,5,8,78,8,99,
Endüstri Mühendisliği,Semih Önüt,0,0,86,6,92,
Endüstri Mühendisliği,"Nezir Aydın, Ph.D.",6,4,35,24,69,
Endüstri Mühendisliği,Alev Taşkın Gümüş,0,4,40,17,61,
Endüstri Mühendisliği,Fatih Yilmaz,1,2,41,14,58,
Endüstri Mühendisliği,Selçuk ALP,3,0,36,7,46,
Endüstri Mühendisliği,Umut R. Tuzkaya,0,2,37,4,43,
Endüstri Mühendisliği,Ali Fuat Güneri,0,2,33,7,42,
Endüstri Mühendisliği,Coşkun ÖZKAN,0,0,27,10,37,
Endüstri Mühendisliği,Özge Nalan BİLİŞİK,5,1,29,1,36,
Endüstri Mühendisliği,Muhammet GÜL,0,0,35,0,35,
Endüstri Mühendisliği,Tufan Demirel,0,0,28,5,33,
Endüstri Mühendisliği,Tuğba Efendigil,0,1,24,8,33,
Endüstri Mühendisliği,Erkan Çelik,0,1,26,2,29,
Endüstri Mühendisliği,Mehmet Güray Güler,9,0,11,9,29,
Endüstri Mühendisliği,Hüseyin BAŞLIGİL,0,1,16,10,27,
Endüstri Mühendisliği,Nihan Çetin Demirel,0,0,26,0,26,
Endüstri Mühendisliği,Selin SONER KARA,0,1,19,6,26,
Endüstri Mühendisliği,Melike ERDOĞAN,2,0,23,0,25,
Endüstri Mühendisliği,Fahrettin Eldemir,0,0,9,12,21,
Endüstri Mühendisliği,Vildan ÖZKIR,6,1,4,9,20,
Endüstri Mühendisliği,Yavuz Özdemir,0,0,19,0,19,
Endüstri Mühendisliği,Mehmet Cabir Akkoyunlu,7,0,12,0,19,
Endüstri Mühendisliği,Muhammet DEVECİ,5,2,11,0,18,
Endüstri Mühendisliği,Bahadır GÜLSÜN,0,0,10,7,17,
Endüstri Mühendisliği,Hande Musdal,0,0,17,0,17,
Endüstri Mühendisliği,Pelin Alcan,0,0,16,0,16,
Endüstri Mühendisliği,K. Büşra YILMAZER,0,1,13,0,14,
Endüstri Mühendisliği,Mert Edalı,4,0,6,4,14,
Endüstri Mühendisliği,Önder Öndemir,0,0,13,0,13,
Endüstri Mühendisliği,Serhat Tüzün,0,0,9,4,13,
Endüstri Mühendisliği,Şahika Koyun Yılmaz,5,0,7,1,13,
Endüstri Mühendisliği,Ceyda Şen,0,2,10,0,12,
Endüstri Mühendisliği,Savaş Balin,0,0,6,6,12,
Endüstri Mühendisliği,Betül Özkan,0,0,12,0,12,
Endüstri Mühendisliği,Hayri BARAÇLI,0,0,8,4,12,
Endüstri Mühendisliği,Serkan Altuntaş,0,0,12,0,12,
Endüstri Mühendisliği,Engin PEKEL,0,0,7,0,7,
Endüstri Mühendisliği,DOĞAN ÖZGEN,0,0,1,6,7,
Endüstri Mühendisliği,Ali Karaşan,5,0,2,0,7,
Endüstri Mühendisliği,Nazlı Gülüm MUTLU,0,0,7,0,7,
Endüstri Mühendisliği,Kürşad Sezai Türker,5,0,0,2,7,
Endüstri Mühendisliği,Onur YILMAZ,0,0,6,0,6,
Endüstri Mühendisliği,S.Kerem AYTULUN,0,0,0,4,4,
Endüstri Mühendisliği,MUSTAFA İME,0,0,0,4,4,
Endüstri Mühendisliği,Gülfem Tuzkaya,0,0,3,0,3,
Endüstri Mühendisliği,Mesut Özgürler,0,0,0,2,2,
Enformatik,ali iskurt,0,0,10,13,23,
Enformatik,İsmail TONBULOĞLU,0,0,20,0,20,
Enformatik,Hasan Tokatlı,8,1,1,2,12,
Enformatik,Serkan Saltürk,4,0,1,1,6,
Enformatik,Tuba SALTÜRK,4,0,2,0,6,
Enformatik,Özlem BAYRAM AKBAY,5,0,0,0,5,
Enformatik,Murat Dağıtmaç,0,0,0,1,1,
Eğitim Bilimleri,Nadir Çeliköz,9,6,172,8,195,
Eğitim Bilimleri,Vefa Taşdelen,6,0,174,5,185,
Eğitim Bilimleri,Mustafa GÜNDÜZ,1,4,164,2,171,
Eğitim Bilimleri,Yavuz Erişen,8,14,88,41,151,
Eğitim Bilimleri,İbrahim KOCABAŞ,5,9,92,4,110,
Eğitim Bilimleri,Mehmet Engin Deniz,6,5,79,9,99,
Eğitim Bilimleri,Hasan Basri GÜNDÜZ,1,6,66,12,85,
Eğitim Bilimleri,Aydın BALYER,7,0,58,17,82,
Eğitim Bilimleri,MEHMET GÜROL,2,1,57,4,64,
Eğitim Bilimleri,Fulya YÜKSEL-ŞAHİN,0,0,45,18,63,
Eğitim Bilimleri,erkan tabancalı,0,3,27,26,56,
Eğitim Bilimleri,Banu Yücel Toy,5,6,34,8,53,
Eğitim Bilimleri,Nermin Çiftçi Arıdağ,4,6,30,10,50,
Eğitim Bilimleri,Şerife Gonca Zeren,1,2,22,19,44,
Eğitim Bilimleri,Sertel Altun,3,3,35,2,43,
Eğitim Bilimleri,Mithat KORUMAZ,4,1,36,1,42,
Eğitim Bilimleri,Bünyamin BAVLI,4,17,17,0,38,
Eğitim Bilimleri,Hakan Karataş,7,2,27,0,36,
Eğitim Bilimleri,Çetin Erdoğan,6,1,18,10,35,
Eğitim Bilimleri,mine çeliköz,5,1,24,1,31,
Eğitim Bilimleri,Yunus Emre Ömür,7,0,20,1,28,
Eğitim Bilimleri,Bülent Alcı,0,0,24,3,27,
Eğitim Bilimleri,Hasan BACANLI,0,0,25,2,27,
Eğitim Bilimleri,Esra Tekel,3,0,22,0,25,
Eğitim Bilimleri,davut hotaman,1,0,15,0,16,
Eğitim Bilimleri,,0,1,13,0,14,
Eğitim Bilimleri,Belkıs KARABIYIK ÇERİ,4,1,9,0,14,
Eğitim Bilimleri,H. Eylem Korkmaz,0,0,12,0,12,
Eğitim Bilimleri,Yağmur Amanvermez,3,1,7,0,11,
Eğitim Bilimleri,Seher Merve Yılmaz Erus,0,1,9,0,10,
Eğitim Bilimleri,M.Osman Kurtkan KAPICIOĞLU,0,2,7,0,9,
Eğitim Bilimleri,ali gümüşeli,0,1,6,0,7,
Eğitim Bilimleri,BÜŞRA TOMBAK,0,0,5,0,5,
Eğitim Bilimleri,Mehmet Şahin,4,0,0,0,4,
Eğitim Bilimleri,Ceren Bektaş,4,0,0,0,4,
Eğitim Bilimleri,Sinem Konuk,1,0,2,0,3,
Eğitim Bilimleri,Evren ERSOY,0,0,2,0,2,
Eğitim Bilimleri,AYNUR YILMAZ AKBABA,0,1,0,0,1,
Eğitim Fakültesi,Mustafa SAĞDIÇ,1,1,34,0,36,
Eğitim Fakültesi,Zehra Taşpınar,Şener,0,0,16,2,18
Felsefe,A. Teyfur ERDOĞDU,4,0,187,0,191,
Felsefe,Alparslan AÇIKGENÇ,0,3,55,3,61,
Felsefe,Songül Demir,1,1,6,14,22,
Felsefe,Ali Çaksu,5,2,5,0,12,
Felsefe,Caner TASLAMAN,0,0,8,2,10,
Felsefe,ÇAĞRI TAŞGETİREN,1,0,0,0,1,
Felsefe,Hanife Bilgili,0,1,0,0,1,
Fen Bilimleri Enstitüsü,ŞÜKRAN ŞEKER,0,0,16,0,16,
Fen Bilimleri Enstitüsü,GÜLSÜM UÇAK,0,2,12,0,14,
Fen Bilimleri Enstitüsü,Rabia Nagehan ÜREGEN,3,1,9,0,13,
Fen Bilimleri Enstitüsü,Sümeyra Bedir,4,0,3,0,7,
Fen Bilimleri Enstitüsü,Ömer Faruk Karaaslan,6,0,1,0,7,
Fen Bilimleri Enstitüsü,Melahat Şahin,0,0,4,0,4,
Fen Bilimleri Enstitüsü,Melih ÇINAR,2,0,1,0,3,
Fen Bilimleri Enstitüsü,Müge Gedik,1,0,0,0,1,
Fen-Edebiyat Fakültesi,Erol KAM,5,6,82,0,93,
Fen-Edebiyat Fakültesi,Murat Sarı,8,5,72,6,91,
Fen-Edebiyat Fakültesi,Niyazi Kahveci,0,0,38,30,68,
Fen-Edebiyat Fakültesi,Lokman Torun,5,7,48,4,64,
Fen-Edebiyat Fakültesi,Zeynel Yalçın,2,4,31,6,43,
Fen-Edebiyat Fakültesi,YAŞAR KARABUL,2,2,29,0,33,
Fen-Edebiyat Fakültesi,Neşe ATACI,4,7,20,0,31,
Fen-Edebiyat Fakültesi,Asuman Aşıkoğlu Bozkurt,4,4,17,0,25,
Fen-Edebiyat Fakültesi,ibrahim demir,3,2,16,0,21,
Fen-Edebiyat Fakültesi,ÖZNUR DÜLGER,0,0,18,0,18,
Fen-Edebiyat Fakültesi,ibrahim güney,1,0,9,2,12,
Fen-Edebiyat Fakültesi,Serkan AKOĞUL,2,0,8,0,10,
Fen-Edebiyat Fakültesi,Gülşen ORUCOVA BÜYÜKÖZ,0,0,6,0,6,
Fen-Edebiyat Fakültesi,Ali Emre Özyıldırım,0,0,1,0,1,
Fen-Edebiyat Fakültesi,A. Göksel Ağargün,0,0,1,0,1,
Fen-Edebiyat Fakültesi,Abdurrahman Erciyas,1,0,0,0,1,
Fizik,Mustafa Okutan,9,10,123,6,148,
Fizik,Orhan İÇELLİ,4,12,106,0,122,
Fizik,Fedai İnanır,8,8,77,15,108,
Fizik,Yusuf Yerli,8,12,74,13,107,
Fizik,Orhan Özdemir,0,8,92,2,102,
Fizik,Ahmet Altındal,3,8,83,1,95,
Fizik,YASEMİN YILDIZ YARAR,6,5,72,8,91,
Fizik,Kemal Özdoğan,9,2,47,31,89,
Fizik,Kutsal Bozkurt,2,8,51,22,83,
Fizik,Yeşim Özcanlı,4,5,49,9,67,
Fizik,Zehra CAN,1,3,43,18,65,
Fizik,Mehmet Hikmet Yükselici,7,8,42,7,64,
Fizik,Banu SÜNGÜ MISIRLIOĞLU,0,9,54,0,63,
Fizik,Zeynep Güven Özdemir,3,3,53,2,61,
Fizik,Nimet YILMAZ CANLI,3,8,46,2,59,
Fizik,Serap Güneş,0,14,45,0,59,
Fizik,Önder YARGI,2,5,45,4,56,
Fizik,Nursel CAN,2,5,27,22,56,
Fizik,Hüseyin Birtan Kavanoz,0,3,44,8,55,
Fizik,Çiğdem Nuhoğlu,3,0,38,9,50,
Fizik,Fatma Pınar Gökdemir,1,7,38,0,46,
Fizik,kubilay kutlu,0,2,28,14,44,
Fizik,Seçkin Dündar Günay,0,5,37,1,43,
Fizik,Birsel CAN ÖMÜR,2,7,29,5,43,
Fizik,Murat Hüdaverdi,0,15,27,0,42,
Fizik,Kenan KOÇ,0,2,39,0,41,
Fizik,Serço Serkis Yeşilkaya,4,4,31,0,39,
Fizik,Tuncer Kaya,2,0,26,11,39,
Fizik,Pelin KAVAK,3,6,30,0,39,
Fizik,Merih Serin,0,22,16,0,38,
Fizik,Macide CANTÜRK RODOP,2,6,24,6,38,
Fizik,Baki Aksakal,8,2,25,0,35,
Fizik,Mehmet Kılıç,0,1,34,0,35,
Fizik,Murat Özer,0,1,30,3,34,
Fizik,Ayşegül Çelik Bozdoğan,3,3,27,0,33,
Fizik,Arzu ÇİLLİ,3,1,22,7,33,
Fizik,Ayşe Evrim Bulgurcuoğlu,0,3,30,0,33,
Fizik,Rıza Demirbilek,2,6,20,4,32,
Fizik,Devrim YAZICI,1,1,24,6,32,
Fizik,Esra Yüksel,3,4,23,0,30,
Fizik,Uğur Deneb Menda,3,6,19,0,28,
Fizik,Ünsal AKDERE,0,4,17,2,23,
Fizik,Reyhan Kaya,4,1,9,9,23,
Fizik,Murat ÇALIŞKAN,0,8,13,1,22,
Fizik,Çiğdem Oruç,0,6,10,0,16,
Fizik,Altan Bozdoğan,4,3,9,0,16,
Fizik,Mehmet Kazici,3,1,12,0,16,
Fizik,Taylan Yetkin,0,1,13,1,15,
Fizik,Hasan TATLIPINAR,1,1,7,5,14,
Fizik,Gülay Dereli,0,3,11,0,14,
Fizik,Hüsnü Kara,9,0,5,0,14,
Fizik,Neslihan Ayarcı Kuruoğlu,3,1,10,0,14,
Fizik,öznur çakır,3,1,8,0,12,
Fizik,Çiğdem Yumuşak,0,0,12,0,12,
Fizik,CENK DENKDAŞ,0,4,5,0,9,
Fizik,Özgür AKÇALI,0,1,1,5,7,
Fizik,Sinem Durmuş,0,7,0,0,7,
Fizik,Ayşe DURUSOY,3,2,1,0,6,
Fizik,Önder EYECİOĞLU,0,2,3,0,5,
Fizik,Seda Erdönmez,0,0,5,0,5,
Fizik,Vildan Tuğyanoğlu,0,0,4,0,4,
Fizik,Mehmet Yılmaz,0,0,3,0,3,
Fizik,Cüneyt Berkdemir,0,0,3,0,3,
Fizik,İSİK Karabay Altenburg,0,1,1,0,2,
Gemi İnşaatı ve Denizcilik Fakültesi,Bahri Şahin,8,7,91,13,119,
Gemi İnşaatı ve Denizcilik Fakültesi,Hüseyin YILMAZ,5,3,17,11,36,
Gemi İnşaatı ve Denizcilik Fakültesi,Veysi Başhan,2,1,5,0,8,
Gemi İnşaatı ve Denizcilik Fakültesi,Ahmet Kaya,3,0,0,0,3,
Gemi İnşaatı ve Gemi Makineleri Mühendisliği,Seyfettin BAYRAKTAR,13,11,53,9,86,
Gemi İnşaatı ve Gemi Makineleri Mühendisliği,Nurten Vardar,2,1,64,0,67,
Gemi İnşaatı ve Gemi Makineleri Mühendisliği,Serkan Ekinci,0,1,56,8,65,
Gemi İnşaatı ve Gemi Makineleri Mühendisliği,Muhsin AYDIN,11,5,21,20,57,
Gemi İnşaatı ve Gemi Makineleri Mühendisliği,ÖMER KEMAL KINACI,4,10,36,4,54,
Gemi İnşaatı ve Gemi Makineleri Mühendisliği,Mesut GÜNER,3,9,37,1,50,
Gemi İnşaatı ve Gemi Makineleri Mühendisliği,ALİ DOĞRUL,5,5,28,12,50,
Gemi İnşaatı ve Gemi Makineleri Mühendisliği,Uğur Buğra ÇELEBİ,0,2,42,4,48,
Gemi İnşaatı ve Gemi Makineleri Mühendisliği,Güven Gonca,0,2,38,5,45,
Gemi İnşaatı ve Gemi Makineleri Mühendisliği,Levent Bilgili,4,2,39,0,45,
Gemi İnşaatı ve Gemi Makineleri Mühendisliği,EDA TURAN,4,0,26,9,39,
Gemi İnşaatı ve Gemi Makineleri Mühendisliği,İsmail Bayer,0,0,4,29,33,
Gemi İnşaatı ve Gemi Makineleri Mühendisliği,Yasemin ARIKAN ÖZDEN,3,4,25,0,32,
Gemi İnşaatı ve Gemi Makineleri Mühendisliği,Muhammed Emin Başak,4,5,16,6,31,
Gemi İnşaatı ve Gemi Makineleri Mühendisliği,Hüseyin ELÇİÇEK,4,6,19,0,29,
Gemi İnşaatı ve Gemi Makineleri Mühendisliği,Özgür DEMİR,6,4,13,5,28,
Gemi İnşaatı ve Gemi Makineleri Mühendisliği,Bülent Güzel,6,4,10,7,27,
Gemi İnşaatı ve Gemi Makineleri Mühendisliği,Ferdi Çakıcı,5,5,17,0,27,
Gemi İnşaatı ve Gemi Makineleri Mühendisliği,Bekir ŞENER,0,5,10,10,25,
Gemi İnşaatı ve Gemi Makineleri Mühendisliği,Fahri ÇELİK,0,1,19,5,25,
Gemi İnşaatı ve Gemi Makineleri Mühendisliği,AHMET YURTSEVEN,5,5,13,0,23,
Gemi İnşaatı ve Gemi Makineleri Mühendisliği,Ahmet Dursun ALKAN,3,2,10,8,23,
Gemi İnşaatı ve Gemi Makineleri Mühendisliği,S.Turgut İnce,5,0,14,0,19,
Gemi İnşaatı ve Gemi Makineleri Mühendisliği,Ümit Güneş,4,0,13,1,18,
Gemi İnşaatı ve Gemi Makineleri Mühendisliği,Asım SİNAN KARAKURT,5,0,11,0,16,
Gemi İnşaatı ve Gemi Makineleri Mühendisliği,Hakan DEMİREL,3,0,12,0,15,
Gemi İnşaatı ve Gemi Makineleri Mühendisliği,Metin Kemal GÖKÇE,1,0,13,0,14,
Gemi İnşaatı ve Gemi Makineleri Mühendisliği,Aykut SAFA,3,0,7,2,12,
Gemi İnşaatı ve Gemi Makineleri Mühendisliği,Savaş SEZEN,3,1,8,0,12,
Gemi İnşaatı ve Gemi Makineleri Mühendisliği,Mustafa Taşkın,4,4,3,0,11,
Gemi İnşaatı ve Gemi Makineleri Mühendisliği,Taner Coşgun,1,2,6,0,9,
Gemi İnşaatı ve Gemi Makineleri Mühendisliği,Feyyaz ARSLAN,4,1,4,0,9,
Gemi İnşaatı ve Gemi Makineleri Mühendisliği,Süleyman DUMAN,5,0,4,0,9,
Gemi İnşaatı ve Gemi Makineleri Mühendisliği,Murat Emre Demir,4,0,2,2,8,
Gemi İnşaatı ve Gemi Makineleri Mühendisliği,Emre KAHRAMANOĞLU,3,0,4,0,7,
Gemi İnşaatı ve Gemi Makineleri Mühendisliği,Ercüment Uğur YÜNCÜOĞLU,0,2,3,0,5,
Gemi İnşaatı ve Gemi Makineleri Mühendisliği,Mehmet BEŞİK,3,0,1,1,5,
Gemi İnşaatı ve Gemi Makineleri Mühendisliği,YÜKSEL PALACI,0,0,0,5,5,
Gemi İnşaatı ve Gemi Makineleri Mühendisliği,VOLKAN ŞAHİN,0,0,3,0,3,
Gemi İnşaatı ve Gemi Makineleri Mühendisliği,Halil İbrahim SÖNMEZ,2,0,1,0,3,
Gemi Makineleri İşletme Mühendisliği,Yasin Üst,7,6,69,0,82,
Gemi Makineleri İşletme Mühendisliği,Ömer SAVAŞ,0,3,28,50,81,
Gemi Makineleri İşletme Mühendisliği,Fuat ALARÇİN,0,1,45,9,55,
Gemi Makineleri İşletme Mühendisliği,Eyup BAĞCI,0,10,32,12,54,
Gemi Makineleri İşletme Mühendisliği,Oktay Yılmaz,9,9,21,8,47,
Gemi Makineleri İşletme Mühendisliği,Hasan Kayhan Kayadelen,14,1,15,11,41,
Gemi Makineleri İşletme Mühendisliği,Ertan ÖZNERGİZ,1,3,22,9,35,
Gemi Makineleri İşletme Mühendisliği,Görkem KÖKKÜLÜNK,3,3,15,3,24,
Gemi Makineleri İşletme Mühendisliği,Fatih Cüneyd Korkmaz,3,1,17,0,21,
Gemi Makineleri İşletme Mühendisliği,Zafer AYDIN,7,2,8,4,21,
Gemi Makineleri İşletme Mühendisliği,Burak YILDIZ,5,0,15,0,20,
Gemi Makineleri İşletme Mühendisliği,Mehmet ÇAKIR,3,6,10,0,19,
Gemi Makineleri İşletme Mühendisliği,Kaan ÜNLÜGENÇOĞLU,6,0,11,0,17,
Gemi Makineleri İşletme Mühendisliği,Tarık KOÇAL,3,0,11,0,14,
Gemi Makineleri İşletme Mühendisliği,Kenan YİĞİT,8,1,0,0,9,
Gemi Makineleri İşletme Mühendisliği,Muhammet Ertuğrul Su,0,0,6,0,6,
Gemi Makineleri İşletme Mühendisliği,Haydar Bayar,0,0,0,5,5,
Gemi Makineleri İşletme Mühendisliği,ilknur Keskin Öner,0,0,1,1,2,
Gıda Mühendisliği,Osman SAĞDIÇ,6,30,294,4,334,
Gıda Mühendisliği,Mustafa Tahsin Yılmaz,6,25,158,11,200,
Gıda Mühendisliği,Muhammet ARICI,5,27,93,8,133,
Gıda Mühendisliği,Ömer Said Toker,6,6,92,0,104,
Gıda Mühendisliği,FATİH TÖRNÜK,4,7,33,11,55,
Gıda Mühendisliği,Salih Karasu,2,5,30,7,44,
Gıda Mühendisliği,M. Zeki Durak,0,16,16,7,39,
Gıda Mühendisliği,Necattin Cihat İÇYER,3,3,11,0,17,
Gıda Mühendisliği,Görkem Özülkü,0,2,10,0,12,
Gıda Mühendisliği,Ahmet Abdullah Us,0,0,7,0,7,
Harita Mühendisliği,bülent bayram,5,13,79,0,97,
Harita Mühendisliği,Naci Yastıklı,9,12,55,5,81,
Harita Mühendisliği,Taylan ÖCALAN,17,6,57,0,80,
Harita Mühendisliği,Türkay Gökgöz,8,7,51,9,75,
Harita Mühendisliği,Hülya DEMİR,0,7,55,12,74,
Harita Mühendisliği,Mehmet ALKAN,6,3,61,3,73,
Harita Mühendisliği,Şerif HEKİMOGLU,0,0,70,1,71,
Harita Mühendisliği,Burak Akpınar,0,9,44,13,66,
Harita Mühendisliği,Engin GÜLAL,5,13,35,8,61,
Harita Mühendisliği,Volkan Çağdaş,8,5,34,13,60,
Harita Mühendisliği,METİN SOYCAN,0,1,57,1,59,
Harita Mühendisliği,Fatmagül Kılıç Gül,4,10,28,13,55,
Harita Mühendisliği,Nedim Onur AYKUT,6,8,35,1,50,
Harita Mühendisliği,Mehmet Gür,11,5,31,0,47,
Harita Mühendisliği,Cüneyt Aydın,4,6,29,8,47,
Harita Mühendisliği,Ercenk ATA,0,6,33,7,46,
Harita Mühendisliği,Füsun Şanlı,0,8,28,8,44,
Harita Mühendisliği,Melih Başaraner,6,0,24,12,42,
Harita Mühendisliği,D.Uğur Şanlı,3,2,24,10,39,
Harita Mühendisliği,Uğur DOĞAN,3,10,22,4,39,
Harita Mühendisliği,Alper Şen,8,1,19,11,39,
Harita Mühendisliği,Bahattin ERDOĞAN,4,1,28,5,38,
Harita Mühendisliği,Atınç PIRTI,4,3,16,13,36,
Harita Mühendisliği,Melis Uzar,8,4,13,11,36,
Harita Mühendisliği,Mustafa Ümit GÜMÜŞAY,0,0,34,0,34,
Harita Mühendisliği,Fatih Gülgen,0,4,21,8,33,
Harita Mühendisliği,KUTALMIŞ GÜMÜŞ,0,3,28,0,31,
Harita Mühendisliği,Nihat ERSOY,0,1,24,4,29,
Harita Mühendisliği,Mustafa Üstüner,4,0,22,0,26,
Harita Mühendisliği,Deniz Öz Demir,0,0,25,0,25,
Harita Mühendisliği,Uğur ACAR,3,3,17,0,23,
Harita Mühendisliği,İbrahim KOÇ,0,0,23,0,23,
Harita Mühendisliği,Halil ERKAYA,0,3,16,3,22,
Harita Mühendisliği,MAHMUT OĞUZ SELBESOĞLU,0,1,16,0,17,
Harita Mühendisliği,Tolga Bakırman,6,3,8,0,17,
Harita Mühendisliği,Seda ÇETİN,2,2,13,0,17,
Harita Mühendisliği,NURSU TUNALIOĞLU,0,0,1,14,15,
Harita Mühendisliği,İbrahim H. Çetin,0,1,11,0,12,
Harita Mühendisliği,Abdullah KARA,0,3,9,0,12,
Harita Mühendisliği,Müslüm Hacar,6,0,6,0,12,
Harita Mühendisliği,Zeynel Abidin POLAT,0,0,11,0,11,
Harita Mühendisliği,Sinan Çetinkaya,0,2,8,0,10,
Harita Mühendisliği,Ahmet YILMAZ,0,1,8,0,9,
Harita Mühendisliği,ARZU SOYCAN,0,4,5,0,9,
Harita Mühendisliği,ADEM GÖKHAN HAYAL,2,1,6,0,9,
Harita Mühendisliği,Abdulkadir Memduhoğlu,6,0,3,0,9,
Harita Mühendisliği,Mert Gürtürk,4,1,3,0,8,
Harita Mühendisliği,Mustafa Durdağ,0,0,7,0,7,
Harita Mühendisliği,Hatice Çatal,0,1,6,0,7,
Harita Mühendisliği,Ramazan Gürsel HOŞBAŞ,5,0,0,2,7,
Harita Mühendisliği,Batuhan KILIÇ,5,0,2,0,7,
Harita Mühendisliği,Ali Hasan Doğan,4,0,3,0,7,
Harita Mühendisliği,Süreyya Özgür Uygur,0,1,5,0,6,
Harita Mühendisliği,Barış Süleymanoğlu,1,1,3,0,5,
Harita Mühendisliği,Aziz SARAÇOĞLU,2,0,3,0,5,
Harita Mühendisliği,Mustafa Fahri Karabulut,0,0,4,1,5,
Harita Mühendisliği,Kadir Şahbaz,5,0,0,0,5,
Harita Mühendisliği,YALÇIN YILMAZ,0,1,2,0,3,
Harita Mühendisliği,Hüseyin DUMAN,0,0,3,0,3,
Harita Mühendisliği,Alpay Özdemir,3,0,0,0,3,
Harita Mühendisliği,Niyazi Arslan,0,0,2,0,2,
Harita Mühendisliği,Güldane Oku,0,0,0,1,1,
İktisadi ve İdari Bilimler Fakültesi,Halit Keskin,0,3,89,10,102,
İktisadi ve İdari Bilimler Fakültesi,Nevin Coşar,5,4,45,13,67,
İktisadi ve İdari Bilimler Fakültesi,Kasım Eren,1,0,21,4,26,
İktisadi ve İdari Programlar,Erol Yavuz,0,0,28,24,52,
İktisadi ve İdari Programlar,Adem ALTAY,7,0,0,30,37,
İktisadi ve İdari Programlar,Ufuk BÖLÜKBAŞ,5,9,12,10,36,
İktisadi ve İdari Programlar,K. Batu Tunay,0,0,36,0,36,
İktisadi ve İdari Programlar,seyfullah demirkaya,0,1,23,0,24,
İktisadi ve İdari Programlar,Muhsin ASLAN,1,4,18,0,23,
İktisadi ve İdari Programlar,Türkan Ayda Gürkan,6,1,0,15,22,
İktisadi ve İdari Programlar,Nuriye BULUT,0,7,1,13,21,
İktisadi ve İdari Programlar,Serpil Bardakçı Tosun,4,0,3,9,16,
İktisadi ve İdari Programlar,MUSTAFA KUTLU,0,2,0,13,15,
İktisadi ve İdari Programlar,Elif KARA ÖZTÜRK,2,0,0,12,14,
İktisadi ve İdari Programlar,EROL MUZIR,0,0,4,0,4,
İktisadi ve İdari Programlar,Recep Başak,3,0,0,0,3,
İktisadi ve İdari Programlar,Mehmet Ali Özkök,0,0,1,0,1,
İktisat,Melike E. BİLDİRİCİ,0,2,134,0,136,
İktisat,Feride Gönel,4,5,60,10,79,
İktisat,Tamer Çetin,1,4,54,5,64,
İktisat,Meral UZUNÖZ,3,4,41,7,55,
İktisat,Fazıl KAYIKÇI,0,0,42,11,53,
İktisat,Seçkin Sunal,2,1,9,32,44,
İktisat,Murat Donduran,4,1,33,6,44,
İktisat,Hasan Ağan Karaduman,2,0,7,25,34,
İktisat,Hüseyin Taştan,0,2,27,1,30,
İktisat,Asuman Oktayer,0,1,16,11,28,
İktisat,Ercan Eren,0,0,26,2,28,
İktisat,Yasemin Asu Çırpıcı,0,1,8,18,27,
İktisat,Tolga Aksoy,3,1,15,8,27,
İktisat,Burak Ünveren,3,2,9,11,25,
İktisat,Gülsün Yay,5,0,14,0,19,
İktisat,Serçin Şahin,0,2,13,0,15,
İktisat,Zeynep Kaplan,0,3,10,0,13,
İktisat,Sırrı Emrah Üçer,1,1,11,0,13,
İktisat,Ensar Yılmaz,0,0,8,3,11,
İktisat,Sedef ŞEN,3,0,3,5,11,
İktisat,Turan Yay,0,0,10,0,10,
İktisat,Müge Akad,3,0,0,6,9,
İktisat,özge kama,0,2,6,0,8,
İktisat,Tunç Durmaz,0,0,8,0,8,
İktisat,Tuna Abdullah Dinç,0,2,5,0,7,
İktisat,Sait Öztürk,0,0,6,0,6,
İktisat,özdemir teke,0,1,4,1,6,
İktisat,Alaaddin Tok,1,0,5,0,6,
İktisat,Nurullah Usta,0,0,1,3,4,
İktisat,YILDIRIM BEYAZIT ÇİÇEN,0,0,3,0,3,
İktisat,Selçuk Gül,0,0,2,1,3,
İktisat,Gaye Sakarya,0,0,0,1,1,
İktisat,Senem Çakmak Şahin,0,0,1,0,1,
İletişim Tasarımı,Umut Burcu Yurtsever,5,0,7,23,35,
İletişim Tasarımı,Adviye Ayça Ünlüer Çimen,0,1,20,13,34,
İletişim Tasarımı,Çağatay Bilsel,23,4,4,0,31,
İletişim Tasarımı,Simge Esin Orhun,0,0,11,9,20,
İletişim Tasarımı,Halil Önal,6,2,5,0,13,
İletişim Tasarımı,Asım Evren Yantaç,0,2,7,1,10,
İletişim Tasarımı,Hikmet Aslı Selçuk,1,0,1,8,10,
İletişim Tasarımı,Tarık Emre YILDIRIM,0,0,9,0,9,
İletişim Tasarımı,Ömer Orhun,0,0,2,4,6,
İlköğretim,Mustafa Arslan,0,20,114,0,134,
İlköğretim,Selim Hilmi Özkan,2,4,87,13,106,
İlköğretim,Mustafa Sami Topçu,5,6,86,7,104,
İlköğretim,Hakan Akçay,3,3,91,0,97,
İlköğretim,Hasan Ünal,10,6,72,1,89,
İlköğretim,Bayram COŞTU,4,6,78,0,88,
İlköğretim,Şahin ORUÇ,4,5,72,0,81,
İlköğretim,Mustafa YEŞİLYURT,4,7,28,30,69,
İlköğretim,Meryem HAYIR KANAT,1,6,42,10,59,
İlköğretim,Adem Cengiz Çevikel,4,1,51,0,56,
İlköğretim,Mustafa Doğan,4,9,41,0,54,
İlköğretim,Ünsal Umdu Topsakal,2,7,42,0,51,
İlköğretim,MUSTAFA ŞEKER,4,4,32,6,46,
İlköğretim,Hülya Kadıoğlu,3,1,19,21,44,
İlköğretim,Ahmet EKŞİ,3,0,33,7,43,
İlköğretim,Elif Bahadır,0,3,34,0,37,
İlköğretim,Sevda GÖKTEPE YILDIZ,0,1,34,0,35,
İlköğretim,Zeynep DOĞAN,0,0,21,12,33,
İlköğretim,Mehmet Nur TUĞLUK,5,3,19,6,33,
İlköğretim,ASLI GÖRGÜLÜ ARI,0,2,29,0,31,
İlköğretim,remziye ceylan,0,1,28,0,29,
İlköğretim,Genç Osman İlhan,0,2,21,5,28,
İlköğretim,Mustafa İÇEN,4,3,18,0,25,
İlköğretim,Mehmet Ayhan,0,0,10,14,24,
İlköğretim,Hasan Özgür KAPICI,4,0,16,0,20,
İlköğretim,Mehmet Faik YILMAZ,0,0,19,0,19,
İlköğretim,Emine Gülhan BAKIRDERE,0,3,16,0,19,
İlköğretim,Bahar UYAR DÜLDÜL,0,1,17,0,18,
İlköğretim,ESRA MACAROGLU AKGUL,0,1,16,0,17,
İlköğretim,Cevdet Şanlı,0,0,15,0,15,
İlköğretim,Sinem TORAMAN,0,0,12,2,14,
İlköğretim,Aysun Gürol,0,0,11,2,13,
İlköğretim,Fulya Damla Kentli,0,1,6,2,9,
İlköğretim,Gülbin ÖZKAN,0,1,7,0,8,
İlköğretim,Muhammet Fatih Doğan,1,0,2,2,5,
İlköğretim,Nihal Yiğitalp,0,0,4,0,4,
İlköğretim,Feride Gök,0,0,2,0,2,
İlköğretim,Muhammet ŞAHAL,0,0,2,0,2,
İnsan ve Toplum Bilimleri,Süleyman Doğan,9,2,105,7,123,
İnsan ve Toplum Bilimleri,M. Sait Özervarlı,6,0,96,7,109,
İnsan ve Toplum Bilimleri,İlhan Kaya,1,6,74,1,82,
İnsan ve Toplum Bilimleri,Fatmagül Demirel,0,0,40,9,49,
İnsan ve Toplum Bilimleri,Setenay Nil Doğan,3,4,28,9,44,
İnsan ve Toplum Bilimleri,Fatma TUNÇ YAŞAR,2,1,38,0,41,
İnsan ve Toplum Bilimleri,betül duman,6,3,26,4,39,
İnsan ve Toplum Bilimleri,Nalan Turna,1,0,16,8,25,
İnsan ve Toplum Bilimleri,Kerem Karaosmanoğlu,1,0,14,8,23,
İnsan ve Toplum Bilimleri,Yusuf Öz,4,3,1,8,16,
İnsan ve Toplum Bilimleri,Neşet TOKU,2,0,9,0,11,
İnsan ve Toplum Bilimleri,Uros Urosevic,0,0,6,3,9,
İnsan ve Toplum Bilimleri,Güneş Sevinç,0,1,7,0,8,
İnsan ve Toplum Bilimleri,Muhammed Fazıl Baş,0,0,5,0,5,
İnsan ve Toplum Bilimleri,Ayşegül Baykan,1,1,0,1,3,
İnsan ve Toplum Bilimleri,Mahmut Zeki Erbay,0,0,0,2,2,
İnşaat Fakültesi,Hayrullah AĞAÇCIOĞLU,5,0,13,0,18,
İnşaat Fakültesi,Mehmet Ozan Yılmaz,5,1,5,3,14,
İnşaat Fakültesi,Fulya İşlek,1,1,2,0,4,
İnşaat Fakültesi,Tuba Bostan,0,0,1,0,1,
İnşaat Mühendisliği,İbrahim YÜKSEL,8,19,110,22,159,
İnşaat Mühendisliği,Nabi Yüzer,3,15,79,8,105,
İnşaat Mühendisliği,Mustafa Sinan Yardım,9,10,60,26,105,
İnşaat Mühendisliği,Şükrü ERSOY,1,10,80,4,95,
İnşaat Mühendisliği,Bilge Doran,5,8,73,9,95,
İnşaat Mühendisliği,Yusuf AYVAZ,4,5,74,5,88,
İnşaat Mühendisliği,Havvanur Kılıç,6,7,62,5,80,
İnşaat Mühendisliği,BARIŞ SEVİM,3,7,60,5,75,
İnşaat Mühendisliği,ali koçak,6,1,52,10,69,
İnşaat Mühendisliği,Zeynep Işık,10,14,33,7,64,
İnşaat Mühendisliği,Halit Özen,4,7,44,6,61,
İnşaat Mühendisliği,Ahmet Gökçe,4,8,23,20,55,
İnşaat Mühendisliği,Mustafa GÜRSOY,3,9,33,6,51,
İnşaat Mühendisliği,Ferit ÇAKIR,3,4,43,0,50,
İnşaat Mühendisliği,Cem Akgüner,0,6,35,8,49,
İnşaat Mühendisliği,Orhan Canpolat,6,7,29,6,48,
İnşaat Mühendisliği,Nihat Kabay,4,7,29,6,46,
İnşaat Mühendisliği,Hande Aladağ,8,5,32,1,46,
İnşaat Mühendisliği,Serkan Bekiroğlu,5,3,34,4,46,
İnşaat Mühendisliği,Özgür ÇAKIR,9,5,29,2,45,
İnşaat Mühendisliği,Saadet Arzu Berilgen,4,3,27,7,41,
İnşaat Mühendisliği,Şenay Atabay,7,3,24,7,41,
İnşaat Mühendisliği,Burak Aydoğan,0,4,30,6,40,
İnşaat Mühendisliği,İsmail Şahin,0,7,20,11,38,
İnşaat Mühendisliği,MURAT E. SELÇUK,0,5,25,8,38,
İnşaat Mühendisliği,Berna AYAT AYDOĞAN,0,5,29,3,37,
İnşaat Mühendisliği,Sema Alacalı,3,1,26,7,37,
İnşaat Mühendisliği,Mehmet Berilgen,0,6,29,2,37,
İnşaat Mühendisliği,AHMET BEŞER KIZILKANAT,0,7,29,0,36,
İnşaat Mühendisliği,Mehmet Şükrü Özçoban,9,6,12,8,35,
İnşaat Mühendisliği,Güray ARSLAN,0,3,30,2,35,
İnşaat Mühendisliği,MUSTAFA ZORBOZAN,0,0,29,6,35,
İnşaat Mühendisliği,Pelin Özener,3,2,23,4,32,
İnşaat Mühendisliği,SUAT AKBULUT,7,5,20,0,32,
İnşaat Mühendisliği,Tolga Görüm,5,4,21,0,30,
İnşaat Mühendisliği,Zeynep Firat Alemdar,4,3,13,10,30,
İnşaat Mühendisliği,Begum Sertyesilisik,0,0,30,0,30,
İnşaat Mühendisliği,Fatih ALEMDAR,9,6,8,6,29,
İnşaat Mühendisliği,Ahmet Doğan,8,7,10,4,29,
İnşaat Mühendisliği,Murat Tonaroğlu,6,0,14,7,27,
İnşaat Mühendisliği,Murat Serdar Kırçıl,1,0,18,7,26,
İnşaat Mühendisliği,Esin Çevik,1,0,15,10,26,
İnşaat Mühendisliği,Cihan Şahin,0,2,23,0,25,
İnşaat Mühendisliği,Güzin Akyıldız Alçura,0,6,7,11,24,
İnşaat Mühendisliği,Nuri ÖZHENDEKCİ,0,0,17,7,24,
İnşaat Mühendisliği,Devrim ÖZHENDEKCİ,0,0,18,5,23,
İnşaat Mühendisliği,Serhan ULUKAYA,3,2,17,0,22,
İnşaat Mühendisliği,Haluk Yüksel,0,2,10,9,21,
İnşaat Mühendisliği,Didem OKTAY,2,3,15,0,20,
İnşaat Mühendisliği,Aslı Pelin Gurgun,5,0,10,5,20,
İnşaat Mühendisliği,Çağrı Mollamahmutoğlu,3,10,3,4,20,
İnşaat Mühendisliği,Muzaffer BÖREKÇİ,3,0,16,0,19,
İnşaat Mühendisliği,cenk budayan,0,1,8,9,18,
İnşaat Mühendisliği,Ayfer Tekin Atacan,0,1,16,0,17,
İnşaat Mühendisliği,HASAN DİLBAS,7,0,10,0,17,
İnşaat Mühendisliği,Ayşe Erdölen,0,1,15,0,16,
İnşaat Mühendisliği,kubilay cihan,0,1,15,0,16,
İnşaat Mühendisliği,AYSE YUKSEL OZAN,0,3,13,0,16,
İnşaat Mühendisliği,Orkun Yılmaz,3,1,11,0,15,
İnşaat Mühendisliği,Gökhan Demirdöğen,0,3,10,2,15,
İnşaat Mühendisliği,Büşra AKTÜRK,3,0,11,0,14,
İnşaat Mühendisliği,Esra Eylem Karataş,3,0,11,0,14,
İnşaat Mühendisliği,mehmet öztürk,6,2,4,2,14,
İnşaat Mühendisliği,Selçuk DEMİR,0,1,10,2,13,
İnşaat Mühendisliği,Yıldırım Serhat Erdoğan,7,0,0,6,13,
İnşaat Mühendisliği,Mustafa Kirkit,0,0,12,0,12,
İnşaat Mühendisliği,Yalçın Yüksel,0,0,10,2,12,
İnşaat Mühendisliği,Durmuş AKKAYA,0,1,10,0,11,
İnşaat Mühendisliği,Mustafa YILDIRIM,0,0,11,0,11,
İnşaat Mühendisliği,Haluk ÇEÇEN,0,1,10,0,11,
İnşaat Mühendisliği,A.Zafer Öztürk,1,0,4,5,10,
İnşaat Mühendisliği,Fevziye Ayça VAROL SARAÇOĞLU,0,2,8,0,10,
İnşaat Mühendisliği,Kutay Özaydın,0,0,9,1,10,
İnşaat Mühendisliği,Çiğdem Özçelik,0,2,4,3,9,
İnşaat Mühendisliği,Erkan Şenol,0,0,6,3,9,
İnşaat Mühendisliği,Rıza Secer Orkun Keskin,0,0,9,0,9,
İnşaat Mühendisliği,Pelin Elif MEZREA,0,0,6,3,9,
İnşaat Mühendisliği,Zafer KÜTÜĞ,0,1,0,7,8,
İnşaat Mühendisliği,H. Anıl Güner,0,0,8,0,8,
İnşaat Mühendisliği,Abdulsamet Saraçoğlu,3,0,5,0,8,
İnşaat Mühendisliği,ALKIZ MERMER,0,0,8,0,8,
İnşaat Mühendisliği,Ali COŞANDAL,5,1,1,0,7,
İnşaat Mühendisliği,Can Kütan,0,0,0,6,6,
İnşaat Mühendisliği,Nejat Nuri ÇETİNKAYA,2,0,0,4,6,
İnşaat Mühendisliği,Mehmet Safa AYDOĞAN,3,0,1,2,6,
İnşaat Mühendisliği,Mehmet KOPUZ,0,0,1,4,5,
İnşaat Mühendisliği,R. Faruk Yükseler,0,1,4,0,5,
İnşaat Mühendisliği,Erdal Kesgin,4,0,1,0,5,
İnşaat Mühendisliği,Namık ESER,0,0,1,4,5,
İnşaat Mühendisliği,Remziye İlayda TAN,0,1,4,0,5,
İnşaat Mühendisliği,Murat Altekin,3,0,1,0,4,
İnşaat Mühendisliği,Hazal Yılmaz,0,0,4,0,4,
İnşaat Mühendisliği,Ali COŞAR,0,0,4,0,4,
İnşaat Mühendisliği,Ezgi KAYA,0,0,2,2,4,
İnşaat Mühendisliği,YURDAKUL AYGÖRMEZ,2,1,1,0,4,
İnşaat Mühendisliği,İrfan COŞKUN,0,0,1,2,3,
İnşaat Mühendisliği,Sacit BACARAN,0,0,3,0,3,
İnşaat Mühendisliği,Abdullah Huzeyfe Akca,0,0,3,0,3,
İnşaat Mühendisliği,Yeşim Çelikoğlu,0,0,2,0,2,
İnşaat Mühendisliği,Ali Mercan,1,1,0,0,2,
İnşaat Mühendisliği,,0,0,1,0,1,
İnşaat Mühendisliği,nuri caykun alpaslan,0,0,1,0,1,
İnşaat Mühendisliği,Rafet Şişman,0,0,0,1,1,
İnşaat Mühendisliği,Zeynep ÜNSAL ASLAN,0,0,0,1,1,
İstatistik,Gülhayat Gölbaşı Şimşek,7,2,51,12,72,
İstatistik,Atıf Ahmet Evren,0,2,41,29,72,
İstatistik,Serpil KILIÇ DEPREN,8,1,36,24,69,
İstatistik,Ömer Bilen,6,7,44,0,57,
İstatistik,Gülder KEMALBAY,3,0,24,21,48,
İstatistik,Filiz Karaman,8,0,27,10,45,
İstatistik,Fatma NOYAN,0,1,40,2,43,
İstatistik,Ali Hakan Büyüklü,10,4,13,11,38,
İstatistik,Doğan Yıldız,3,4,16,13,36,
İstatistik,Fulya GÖKALP YAVUZ,11,4,16,0,31,
İstatistik,Erhan Çene,7,0,19,0,26,
İstatistik,Ersoy Öz,0,0,23,1,24,
İstatistik,Mehmet Fatih Karaaslan,5,1,16,0,22,
İstatistik,Reşit Çelik,5,1,15,0,21,
İstatistik,ELİF TUNA,0,2,16,0,18,
İstatistik,Hasan Aykut Karaboğa,10,2,6,0,18,
İstatistik,Özlem Berak,0,0,3,12,15,
İstatistik,Öyküm Esra AŞKIN,0,1,11,0,12,
İstatistik,Gözde Ergin,5,1,6,0,12,
İstatistik,Şeyma ÇALIŞKAN ÇAVDAR,0,0,7,0,7,
İstatistik,Coşkun PARİM,1,0,6,0,7,
İstatistik,Abbas Azimli,0,0,6,0,6,
İstatistik,Fatma Sevinç KURNAZ,5,0,1,0,6,
İstatistik,ENES FİLİZ,3,0,1,0,4,
İstatistik,BATUHAN ÖZKAN,0,0,2,0,2,
İşletme,Güler ARAS,0,8,177,5,190,
İşletme,Serdar Bozkurt,4,5,47,44,100,
İşletme,Kenan Aydın,0,5,64,0,69,
İşletme,Selim AREN,2,2,38,27,69,
İşletme,Halil Emre Akbaş,0,1,24,25,50,
İşletme,Yasemin Bal,2,3,36,8,49,
İşletme,Yasin Şehitoğlu,3,1,23,10,37,
İşletme,Ebru Enginkaya Erkent,3,1,19,13,36,
İşletme,Tuğçe Ozansoy Çadırcı,5,0,15,16,36,
İşletme,Arzu Karaman Akgül,0,2,29,0,31,
İşletme,İbrahim Kırcova,1,1,28,1,31,
İşletme,AYGÜL TURAN,0,0,21,6,27,
İşletme,ÖZLEM KUTLU FURTUNA,0,3,17,4,24,
İşletme,Arzu ÖZSÖZGÜN ÇALIŞKAN,0,0,18,6,24,
İşletme,Pınar Büyükbalcı,0,1,22,1,24,
İşletme,Yonca Gürol,8,0,11,4,23,
İşletme,Reşat Saraoğlu,0,0,15,8,23,
İşletme,Esin ERTEMSİR,0,0,18,5,23,
İşletme,Esin CAN,4,2,13,3,22,
İşletme,İsmail Duymaz,0,0,15,6,21,
İşletme,Emel ESEN,0,2,15,0,17,
İşletme,cemal zehir,5,0,10,0,15,
İşletme,Turhan Erkmen,0,1,13,0,14,
İşletme,Şirin Gizem Köse,3,0,11,0,14,
İşletme,Gökmen Gündoğdu,5,0,5,2,12,
İşletme,Nihat Erdoğmuş,5,1,0,5,11,
İşletme,Hasan Ali Kaplan,3,0,5,0,8,
İşletme,Hakan Yılmaz,0,1,7,0,8,
İşletme,Ceren ERDİN GÜNDOĞDU,0,0,7,0,7,
İşletme,Tuğba HIDIRLAR,0,1,5,0,6,
İşletme,Mehmet Çağlar,0,0,6,0,6,
İşletme,AYŞE DEMİRHAN,0,0,5,0,5,
İşletme,A. Murat Demircioğlu,0,0,5,0,5,
İşletme,SEDA CANİKLİ,0,0,5,0,5,
İşletme,Salih Durer,0,0,4,0,4,
İşletme,Arzu Şen,0,0,4,0,4,
İşletme,Sema Aydın,0,0,2,0,2,
İşletme,Sevgin BATUK,0,0,1,0,1,
İşletme,Fatma Hilal Ergen,0,0,1,0,1,
İşletme,Sanem Kaptanoğlu,0,1,0,0,1,
Kimya,Zekiye ÇINAR,0,15,187,9,211,
Kimya,Özlem Cankurtaran,0,10,178,0,188,
Kimya,Osman Çakmak,8,17,143,16,184,
Kimya,Kadir Turhan,0,15,120,34,169,
Kimya,Sezgin BAKIRDERE,9,7,130,0,146,
Kimya,Hale OCAK,5,24,89,13,131,
Kimya,Sevgi Kocaoba,2,9,96,12,119,
Kimya,Nergis Arsu,16,8,79,3,106,
Kimya,Tarık Eren,7,9,41,49,106,
Kimya,Yücel ŞAHİN,6,27,62,11,106,
Kimya,Ayşegül PEKSEL,8,10,75,10,103,
Kimya,Ferdane Karaman,8,14,76,0,98,
Kimya,Fatih Çakar,0,2,90,3,95,
Kimya,Bahadır KESKİN,6,18,70,1,95,
Kimya,BELKIZ BİLGİN ERAN,5,16,72,0,93,
Kimya,Ali ERDOĞMUŞ,0,15,64,1,80,
Kimya,Metin Tülü,6,13,45,8,72,
Kimya,Fatma Tülay Tuğcu,4,3,38,25,70,
Kimya,Ayfer SARAÇ,7,16,43,3,69,
Kimya,Dolunay Şakar Daşdan,2,20,35,9,66,
Kimya,Emine KARAKUŞ,4,8,43,8,63,
Kimya,Muhammet Kasım ŞENER,0,3,48,7,58,
Kimya,Demet Karaca Balta,7,13,32,6,58,
Kimya,HÜSNÜ CANKURTARAN,3,9,39,6,57,
Kimya,Ömer Tahir Günkara,3,7,42,0,52,
Kimya,ULVİ AVCIATA,0,6,36,10,52,
Kimya,müzeyyen DOĞAN,5,2,18,27,52,
Kimya,Özlem Yazıcı,0,6,42,0,48,
Kimya,Şule DİNÇ ZOR,3,1,41,0,45,
Kimya,Zehra Nüket Öcal Sunguroğlu,4,11,29,0,44,
Kimya,Zuhal Turgut,3,5,31,4,43,
Kimya,NİLAY ALTAŞ,5,5,33,0,43,
Kimya,Melda Altıkatoglu Yapaöz,1,12,28,0,41,
Kimya,Sevnur KESKİN DOĞRUYOL,11,11,16,1,39,
Kimya,Feray Aydoğan,0,12,27,0,39,
Kimya,Çiğdem Yörür Göreci,7,14,16,0,37,
Kimya,Çiğdem Yolaçan,3,12,22,0,37,
Kimya,Mevlüde Canlıca,0,7,23,7,37,
Kimya,İBRAHİM ERDEN,6,11,16,2,35,
Kimya,Abdürrezzak Emin Bozdoğan,0,6,29,0,35,
Kimya,Hüseyin YILDIRIM,0,0,35,0,35,
Kimya,Meral Aydın,0,12,20,0,32,
Kimya,Barbaros Nalbantoğlu,0,7,25,0,32,
Kimya,Nevim San,5,3,13,9,30,
Kimya,Dila Kaya,0,2,25,0,27,
Kimya,Gülten Çetin,5,4,10,6,25,
Kimya,İnci Sönmezoğlu,0,1,22,0,23,
Kimya,bürge aşçı,0,4,19,0,23,
Kimya,Fatma Aytan KILIÇARSLAN,0,7,15,0,22,
Kimya,İbrahim Ethem Özyiğit,0,4,18,0,22,
Kimya,Arzu HATİPOĞLU,0,6,15,0,21,
Kimya,Gürkan KARANLIK,0,4,17,0,21,
Kimya,SEMİH GÖRDÜK,3,1,15,0,19,
Kimya,Çağdaş Büyükpınar,0,5,14,0,19,
Kimya,Gülnur KESER KARAOĞLAN,0,4,14,0,18,
Kimya,Ali Serol Ertürk,0,4,14,0,18,
Kimya,Gülşah GÜMRÜKÇÜ KÖSE,0,4,14,0,18,
Kimya,ümit nazlı türkten,0,2,15,0,17,
Kimya,volkan sozer,0,2,15,0,17,
Kimya,Özge Koyun,3,1,13,0,17,
Kimya,Özlem Aksu Dönmez,0,2,14,0,16,
Kimya,ikbal koyuncu,0,3,2,11,16,
Kimya,ERDOĞAN KİRPİ,3,5,8,0,16,
Kimya,Mahmure Özgür,0,5,10,0,15,
Kimya,Göknur YAŞA ATMACA,0,1,14,0,15,
Kimya,türkan börklü budak,0,3,11,0,14,
Kimya,Güzin Alpdoğan,0,0,12,0,12,
Kimya,sabiha yalçın,0,11,0,0,11,
Kimya,Filiz İmer,0,1,9,0,10,
Kimya,Mehmet Arif KAYA,0,3,6,0,9,
Kimya,Fatma Turak,0,3,5,0,8,
Kimya,Fikriye Tüncel Elmalı,0,0,7,0,7,
Kimya,Nebahat Demirhan,0,1,6,0,7,
Kimya,Sibel Eken Korkut,0,0,5,0,5,
Kimya,ÜMRAN DURU KAMACI,0,1,4,0,5,
Kimya,Ahmet Lütfi UĞUR,0,0,3,0,3,
Kimya,Mustafa DEMİRELLİ,0,0,3,0,3,
Kimya,Basri Demiryürek,0,1,0,1,2,
Kimya,Mesut Karahan,0,0,1,0,1,
Kimya Mühendisliği,Sabriye Pişkin,0,24,309,17,350,
Kimya Mühendisliği,Emek MÖRÖYDOR DERUN,13,19,202,13,247,
Kimya Mühendisliği,Mualla Öner,0,23,191,7,221,
Kimya Mühendisliği,Belma KIN ÖZBEK,0,21,147,11,179,
Kimya Mühendisliği,Azmi Seyhun Kıpçak,9,9,140,8,166,
Kimya Mühendisliği,Ülker Beker,5,18,119,0,142,
Kimya Mühendisliği,Nil Acaralı,8,10,92,9,119,
Kimya Mühendisliği,Aysel KANTÜRK FİGEN,6,17,88,5,116,
Kimya Mühendisliği,İbrahim DOYMAZ,5,3,80,18,106,
Kimya Mühendisliği,Mesut Akgün,7,11,76,8,102,
Kimya Mühendisliği,Nurcan Tuğrul,0,8,89,2,99,
Kimya Mühendisliği,Dilek KILIÇ APAR,0,12,83,0,95,
Kimya Mühendisliği,Emel Akyol,5,17,60,5,87,
Kimya Mühendisliği,Yasemen Kalpaklı,0,10,66,8,84,
Kimya Mühendisliği,Seyfullah KEYF,13,12,21,38,84,
Kimya Mühendisliği,Z.Sema Baykara,4,13,60,4,81,
Kimya Mühendisliği,Müge SARI YILMAZ,4,13,61,2,80,
Kimya Mühendisliği,Sennur DENİZ,0,7,44,22,73,
Kimya Mühendisliği,Elçin DEMİRHAN YILMAZ,0,6,64,1,71,
Kimya Mühendisliği,Özgül Dere Özdemir,0,12,59,0,71,
Kimya Mühendisliği,HASAN SADIKOĞLU,5,11,45,3,64,
Kimya Mühendisliği,Dilek Duranoğlu,6,11,37,8,62,
Kimya Mühendisliği,Osman İsmail,4,4,42,8,58,
Kimya Mühendisliği,Yavuz Salt,0,9,39,10,58,
Kimya Mühendisliği,Semra Kırboğa Okumuş,0,9,47,0,56,
Kimya Mühendisliği,İnci Salt,4,10,34,8,56,
Kimya Mühendisliği,Ayça Meriç Hasanoğlu,0,13,38,0,51,
Kimya Mühendisliği,Halit Eren Figen,5,9,34,0,48,
Kimya Mühendisliği,Özlem Doğan Aydeniz,3,12,22,7,44,
Kimya Mühendisliği,Berceste Beyribey Price,3,3,38,0,44,
Kimya Mühendisliği,Ekin KIPÇAK,0,2,36,0,38,
Kimya Mühendisliği,FATMA JALE GÜLEN,0,3,26,1,30,
Kimya Mühendisliği,MERAL YILDIRIM,4,5,20,0,29,
Kimya Mühendisliği,Tuğçe Bekat,3,3,19,0,25,
Kimya Mühendisliği,Burcu Didem Çorbacıoğlu,1,4,16,3,24,
Kimya Mühendisliği,ilknur kucuk,0,9,15,0,24,
Kimya Mühendisliği,Muhammed Enes Oruç,4,4,16,0,24,
Kimya Mühendisliği,Hediye İrem Özgündüz,0,2,18,0,20,
Kimya Mühendisliği,Selen Ezgi ÇELİK,3,0,14,0,17,
Kimya Mühendisliği,SİNEM ŞİMŞEK,4,0,5,4,13,
Kimya Mühendisliği,Berrin SAYGI,3,2,7,0,12,
Kimya Mühendisliği,Elif Öztürk,6,2,3,0,11,
Kimya Mühendisliği,Şule Ünal,0,2,5,0,7,
Kimya Mühendisliği,DEMET ÖZALTUN,3,0,2,0,5,
Kimya Mühendisliği,Günay Baydar Atak,2,0,0,0,2,
Kimya-Metalurji Fakültesi,Perihan Kübra ÇİÇEK,4,2,10,0,16,
Kimya-Metalurji Fakültesi,Sevinç Korkmaz,0,0,8,0,8,
Kimya-Metalurji Fakültesi,Abdullah Bilal Öztürk,4,1,0,0,5,
Kontrol ve Otomasyon Mühendisliği,Galip Cansever,12,21,94,10,137,
Kontrol ve Otomasyon Mühendisliği,İLKER ÜSTOĞLU,11,4,54,5,74,
Kontrol ve Otomasyon Mühendisliği,Türker Türker,4,3,19,25,51,
Kontrol ve Otomasyon Mühendisliği,Özgür Turay Kaymakçı,12,7,24,6,49,
Kontrol ve Otomasyon Mühendisliği,İbrahim Beklan Küçükdemiral,7,3,31,6,47,
Kontrol ve Otomasyon Mühendisliği,Akın Delibaşı,0,7,25,5,37,
Kontrol ve Otomasyon Mühendisliği,Janset Daşdemir,2,1,17,15,35,
Kontrol ve Otomasyon Mühendisliği,Levent Ucun,4,5,11,15,35,
Kontrol ve Otomasyon Mühendisliği,Haluk Görgün,0,10,16,7,33,
Kontrol ve Otomasyon Mühendisliği,Yavuz Eren,5,4,16,6,31,
Kontrol ve Otomasyon Mühendisliği,Tarık Mumcu,0,3,19,3,25,
Kontrol ve Otomasyon Mühendisliği,Fatma Yıldız Taşcıkaraoğlu,0,6,14,3,23,
Kontrol ve Otomasyon Mühendisliği,Muharrem Mercimek,6,0,9,6,21,
Kontrol ve Otomasyon Mühendisliği,Yusuf ALTUN,0,0,16,0,16,
Kontrol ve Otomasyon Mühendisliği,Onur AKBATI,0,5,8,0,13,
Kontrol ve Otomasyon Mühendisliği,Gülsüm Gezer,0,1,8,2,11,
Kontrol ve Otomasyon Mühendisliği,Halit Örenbaş,0,1,7,3,11,
Kontrol ve Otomasyon Mühendisliği,ESRA KAYA AYANA,3,0,3,5,11,
Kontrol ve Otomasyon Mühendisliği,Muhammet Ali Öz,0,0,7,3,10,
Kontrol ve Otomasyon Mühendisliği,Elif Çiçek,0,0,6,3,9,
Kontrol ve Otomasyon Mühendisliği,İbrahim ŞENER,0,0,8,0,8,
Kontrol ve Otomasyon Mühendisliği,Özgür Aktekin,0,1,0,5,6,
Kontrol ve Otomasyon Mühendisliği,Bilal EROL,0,0,4,2,6,
Kontrol ve Otomasyon Mühendisliği,Şeref Naci Engin,0,0,0,6,6,
Kontrol ve Otomasyon Mühendisliği,Semih Dinç,0,1,3,0,4,
Kontrol ve Otomasyon Mühendisliği,İBRAHİM ALIŞKAN,0,1,2,0,3,
Makine Fakültesi,İbrahim Dinçer,0,23,156,0,179,
Makine Mühendisliği,Surkay Akbarov,0,11,346,3,360,
Makine Mühendisliği,Rahmi GÜÇLÜ,4,16,106,6,132,
Makine Mühendisliği,A.Selim DALKILIÇ,3,4,115,0,122,
Makine Mühendisliği,AYŞEGÜL AKDOĞAN EKER,13,9,72,8,102,
Makine Mühendisliği,Alper Uysal,7,5,56,3,71,
Makine Mühendisliği,Ali PINARBAŞI,6,10,49,6,71,
Makine Mühendisliği,Özgen Ü. Çolak Çakır,5,9,46,3,63,
Makine Mühendisliği,Halil Özer,6,0,54,0,60,
Makine Mühendisliği,ORHAN ÇAKIR,2,0,55,1,58,
Makine Mühendisliği,Mihrigül ALTAN,10,6,34,7,57,
Makine Mühendisliği,Muammer Özkan,12,11,28,5,56,
Makine Mühendisliği,Ali Volkan AKKAYA,6,5,30,14,55,
Makine Mühendisliği,Ş.Özgür ATAYILMAZ,0,13,28,14,55,
Makine Mühendisliği,Tolga Mert,6,4,45,0,55,
Makine Mühendisliği,Hasan Hüseyin ERDEM,4,5,40,4,53,
Makine Mühendisliği,Hakan YAZICI,0,2,50,1,53,
Makine Mühendisliği,ŞABAN PUSAT,9,11,32,0,52,
Makine Mühendisliği,Muzaffer Metin,3,8,35,6,52,
Makine Mühendisliği,Hakan Kaleli,11,5,28,7,51,
Makine Mühendisliği,Bedri Onur KÜÇÜKYILDIRIM,8,4,31,6,49,
Makine Mühendisliği,Erhan Altan,0,5,38,3,46,
Makine Mühendisliği,İbrahim Şahin,3,0,9,33,45,
Makine Mühendisliği,MERAL BAYRAKTAR,0,2,34,8,44,
Makine Mühendisliği,Ali Serdar Vanlı,5,6,32,0,43,
Makine Mühendisliği,Muharrem E. Boğoçlu,10,14,12,6,42,
Makine Mühendisliği,Burhanettin Çetin,5,4,28,3,40,
Makine Mühendisliği,Orkun ÖZENER,6,5,24,3,38,
Makine Mühendisliği,Deniz ULUSARSLAN,5,2,22,9,38,
Makine Mühendisliği,Özden Ağra,4,4,26,3,37,
Makine Mühendisliği,Nuri Alpay Kürekci,3,1,32,1,37,
Makine Mühendisliği,Levent Yüksek,0,1,30,6,37,
Makine Mühendisliği,Hakan Demir,0,0,29,3,32,
Makine Mühendisliği,Cenk Onan,6,1,22,2,31,
Makine Mühendisliği,ZEHRA YUMURTACI,12,5,9,4,30,
Makine Mühendisliği,Tamer Kepceler,0,0,28,2,30,
Makine Mühendisliği,Mehmet BOZCA,2,0,24,4,30,
Makine Mühendisliği,Tarkan Sandalcı,0,6,23,1,30,
Makine Mühendisliği,Gönül Füsun Alışverişçi,0,0,24,5,29,
Makine Mühendisliği,Binnur Sağbaş,0,2,23,4,29,
Makine Mühendisliği,Olcay Kıncay,0,0,28,1,29,
Makine Mühendisliği,C. Oktay Azeloğlu,0,6,18,3,27,
Makine Mühendisliği,Alican Çebi,7,2,18,0,27,
Makine Mühendisliği,Ferhat DİKMEN,3,1,18,4,26,
Makine Mühendisliği,Övün Işın,6,5,15,0,26,
Makine Mühendisliği,Semih Sezer,0,8,18,0,26,
Makine Mühendisliği,Ali CELEN,3,1,21,0,25,
Makine Mühendisliği,Uzm. Seyhan ÖZEN,4,3,2,15,24,
Makine Mühendisliği,Derya Burcu ÖZKAN,0,3,11,10,24,
Makine Mühendisliği,Hüseyin Bayıroğlu,0,0,21,3,24,
Makine Mühendisliği,Abdulkerim Okbaz,6,1,17,0,24,
Makine Mühendisliği,Mehmet Emin YURCİ,0,4,13,5,22,
Makine Mühendisliği,Mehmet Salih Cellek,11,2,9,0,22,
Makine Mühendisliği,Yasin Karagöz,0,1,19,0,20,
Makine Mühendisliği,Alp Tekin ERGENÇ,0,8,6,4,18,
Makine Mühendisliği,Aslı Günay Bulutsuz,0,3,15,0,18,
Makine Mühendisliği,Ahmet Çelik,0,0,17,0,17,
Makine Mühendisliği,AHMET SAĞIRLI,0,4,8,5,17,
Makine Mühendisliği,Anıl AKDOĞAN,4,7,2,4,17,
Makine Mühendisliği,Mustafa Tahir AKKOYUNLU,5,5,7,0,17,
Makine Mühendisliği,Birgül Aşçıoğlu Temiztaş,4,1,10,2,17,
Makine Mühendisliği,Meltem Demirci,0,5,12,0,17,
Makine Mühendisliği,Yakup KARAKOYUN,4,0,12,0,16,
Makine Mühendisliği,Serkan ERDEM,0,1,14,0,15,
Makine Mühendisliği,Ali AVCI,5,2,8,0,15,
Makine Mühendisliği,Mine Uslu Uysal,0,3,11,0,14,
Makine Mühendisliği,Alpay Oral,0,4,7,3,14,
Makine Mühendisliği,Nurullah KAYACI,0,0,14,0,14,
Makine Mühendisliği,Alperen ACAR,0,3,7,1,11,
Makine Mühendisliği,Kerem Asmaz,0,1,10,0,11,
Makine Mühendisliği,mahmut paksoy,1,2,7,0,10,
Makine Mühendisliği,Bora Şener,2,2,6,0,10,
Makine Mühendisliği,M. Mert Egilmez,4,1,5,0,10,
Makine Mühendisliği,UĞUR EMİROĞLU,4,1,5,0,10,
Makine Mühendisliği,İlyas İstif,0,0,5,4,9,
Makine Mühendisliği,Osman KOÇ,3,2,1,3,9,
Makine Mühendisliği,BİLLUR KANER,0,0,4,5,9,
Makine Mühendisliği,Engin Erbayrak,2,1,6,0,9,
Makine Mühendisliği,İlkay Kurt,0,1,7,0,8,
Makine Mühendisliği,Aydın DÖNMEZ,4,0,4,0,8,
Makine Mühendisliği,Cihan Demir,0,2,4,2,8,
Makine Mühendisliği,A.Oğuzhan Ahan,3,0,5,0,8,
Makine Mühendisliği,ATİLLA BOZACI,0,0,0,6,6,
Makine Mühendisliği,ÖZLEM EMANET,1,0,5,0,6,
Makine Mühendisliği,Emre Orak,0,0,6,0,6,
Makine Mühendisliği,Yunus Ali Çengel,0,0,6,0,6,
Makine Mühendisliği,Özgen Açıkgöz,0,1,5,0,6,
Makine Mühendisliği,Hüseyin GÜRBÜZ,0,1,5,0,6,
Makine Mühendisliği,Selahattin Yumurtacı,0,1,1,4,6,
Makine Mühendisliği,Firstname Lastname'',0,1,2,2,5,
Makine Mühendisliği,İsmail Teke,0,0,5,0,5,
Makine Mühendisliği,Hüseyin Sönmez,0,1,0,4,5,
Makine Mühendisliği,Volkan Ersoy,0,0,4,1,5,
Makine Mühendisliği,Umut KINIT,0,0,3,1,4,
Makine Mühendisliği,Murat Kıyak,2,0,1,1,4,
Makine Mühendisliği,M.Handan Çubuk,0,0,0,4,4,
Makine Mühendisliği,Fatih Ertuğrul Öz.,0,0,4,0,4,
Makine Mühendisliği,Ali Osman Ayhan,0,1,3,0,4,
Makine Mühendisliği,Berna Bolat,0,0,4,0,4,
Makine Mühendisliği,Hüseyin Aggümüş,0,2,2,0,4,
Makine Mühendisliği,MEHMET ZAHİD BAŞAK,0,1,3,0,4,
Makine Mühendisliği,Hamit Kenan,0,1,3,0,4,
Makine Mühendisliği,ŞÜKRÜ BEKDEMİR,0,1,3,0,4,
Makine Mühendisliği,N. Javani,0,0,0,4,4,
Makine Mühendisliği,Gökhan HASAN,0,2,1,0,3,
Makine Mühendisliği,Burak ALTINOK,0,0,0,3,3,
Makine Mühendisliği,Sefa Kale,0,1,2,0,3,
Makine Mühendisliği,uğur güven,0,0,3,0,3,
Makine Mühendisliği,Fatih Sorgulu,2,0,0,1,3,
Makine Mühendisliği,Zeynep Duriye BİLGE,0,0,0,2,2,
Makine Mühendisliği,Ramazan BAYRAK,2,0,0,0,2,
Makine Mühendisliği,Hasan Alpay heperkan,0,0,1,0,1,
Makine Mühendisliği,Nurullah Gültekin,0,0,0,1,1,
Matematik,SALİM YÜCE,3,2,115,0,120,
Matematik,Selmahan Selim,3,2,14,101,120,
Matematik,Erdal Gül,6,0,21,33,60,
Matematik,Bayram Ali ERSOY,5,12,41,1,59,
Matematik,Nurten GÜRSES,6,1,27,13,47,
Matematik,Filiz Kanbay,2,0,25,17,44,
Matematik,Ömer Gök,0,0,44,0,44,
Matematik,Mehmet Emin KÖROĞLU,3,2,30,8,43,
Matematik,Mustafa DÜLDÜL,2,0,33,4,39,
Matematik,Mustafa Sivri,0,0,38,0,38,
Matematik,Salih Çelik,3,0,34,0,37,
Matematik,Erdoğan Mehmet Özkan,0,2,33,1,36,
Matematik,Beyza ÖZKÖK,7,3,22,3,35,
Matematik,Özgür Yıldırım,0,1,31,1,33,
Matematik,Özlem Bakşi,1,0,15,15,31,
Matematik,SERPİL KARAYEL,1,0,9,20,30,
Matematik,Mutlu AKAR,7,1,21,0,29,
Matematik,Fatih Demirkale,3,4,22,0,29,
Matematik,Yusuf ZEREN,0,0,16,12,28,
Matematik,G. Yeliz ŞENTÜRK,4,0,10,14,28,
Matematik,Gürsel Yeşilot,3,1,21,0,25,
Matematik,Nilgün Aygör,0,0,21,4,25,
Matematik,Faik GÜRSOY,1,1,23,0,25,
Matematik,Serkan Onar,5,1,19,0,25,
Matematik,Emre Kolotoğlu,1,0,15,9,25,
Matematik,S. Ebru Daş,2,0,18,3,23,
Matematik,Hülya Burhanzade,0,1,20,2,23,
Matematik,İsmail Aydoğdu,0,0,22,0,22,
Matematik,Fatih Temiz,4,0,8,7,19,
Matematik,Muttalip Özavşar,2,0,14,2,18,
Matematik,Fatih Demirkale,3,4,11,0,18,
Matematik,Murat Alan,0,0,17,0,17,
Matematik,Elif TEKİN TARIM,1,1,13,1,16,
Matematik,Elif Segah ÖZTAŞ,1,2,13,0,16,
Matematik,Mustafa SARI,2,0,14,0,16,
Matematik,Yunus ATALAN,1,0,15,0,16,
Matematik,Ayten Özkan,0,0,15,0,15,
Matematik,Mustafa Bayram GÜCEN,0,0,15,0,15,
Matematik,Nuran Güzel,4,0,9,2,15,
Matematik,Elif DEMİR,1,0,8,6,15,
Matematik,Oya Baykal ÜNAL,0,0,13,0,13,
Matematik,Müzeyyen Ertürk,0,0,13,0,13,
Matematik,N. Ayşen Özkirişci,2,0,10,0,12,
Matematik,MEHMET AHLATCIOĞLU,0,0,11,1,12,
Matematik,MELTEM UZUN,0,0,12,0,12,
Matematik,Erhan ÇALIŞKAN,0,2,9,0,11,
Matematik,Fatmanur Gürsoy,3,1,7,0,11,
Matematik,Mücahit AKBIYIK,0,0,10,0,10,
Matematik,Seda Kızılbudak Çalışkan,2,0,4,3,9,
Matematik,Fatma Öztürk Çeliker,0,0,9,0,9,
Matematik,Seda AKBIYIK,3,0,6,0,9,
Matematik,Pınar Albayrak,0,0,7,0,7,
Matematik,Fatma Tiryaki,0,0,6,0,6,
Matematik,Ayşegül KETEN,2,0,4,0,6,
Matematik,Fatma BULUT,1,0,4,0,5,
Matematik,Veli ÇOLAK,3,0,2,0,5,
Matematik,Sümeyra Çağlak,3,0,2,0,5,
Matematik,Ferhat Kürüz,3,0,2,0,5,
Matematik,DENİZ SÖNMEZ,5,0,0,0,5,
Matematik,Yonca Sezer,1,0,3,0,4,
Matematik,yasemin alagoz,1,0,3,0,4,
Matematik,Esra ERKAN,1,0,0,3,4,
Matematik,Servet Es,3,0,0,0,3,
Matematik,Şebnem YILDIZ PESTİL,0,0,3,0,3,
Matematik,Zehra Bilgin,0,0,2,1,3,
Matematik,Serpil Uslu,0,0,0,2,2,
Matematik,Özcan Bektaş,0,0,2,0,2,
Matematik,ZERRİN ÖZÇUBUKCU,0,0,0,2,2,
Matematik,Esengül Saltürk,0,0,1,0,1,
Matematik,Ayşe Sharland,0,0,1,0,1,
Matematik,Sultan A. Çelik,0,0,1,0,1,
Matematik,Işım Genç DEMİRİZ,0,0,1,0,1,
Matematik,Murat Turhan,0,0,1,0,1,
Matematik Mühendisliği,Vatan Karakaya,5,15,124,10,154,
Matematik Mühendisliği,Mustafa Bayram,3,7,125,11,146,
Matematik Mühendisliği,Aydın Seçer,13,18,71,14,116,
Matematik Mühendisliği,Nazmiye Yahnioğlu,0,7,94,7,108,
Matematik Mühendisliği,Hülya Şahintürk,6,7,37,9,59,
Matematik Mühendisliği,Ayla ŞAYLI,6,12,30,11,59,
Matematik Mühendisliği,Muhammet Kurulay,0,3,52,0,55,
Matematik Mühendisliği,Coşkun Güler,5,2,39,9,55,
Matematik Mühendisliği,Ülkü (Babuşcu) Yeşil,6,1,22,23,52,
Matematik Mühendisliği,Fatma AYDIN AKGUN,6,1,26,16,49,
Matematik Mühendisliği,Mehmet Ali Akınlar,3,1,44,0,48,
Matematik Mühendisliği,Hale Gonce Köçken,9,2,26,10,47,
Matematik Mühendisliği,Armagan Elibol,2,4,32,4,42,
Matematik Mühendisliği,İnci Albayrak,3,2,30,5,40,
Matematik Mühendisliği,İsmail Küçük,0,1,34,5,40,
Matematik Mühendisliği,Yasemen UÇAN,3,1,11,23,38,
Matematik Mühendisliği,Birol Aslanyürek,0,2,14,16,32,
Matematik Mühendisliği,Samet Yücel KADIOĞLU,3,1,14,10,28,
Matematik Mühendisliği,Fügen Torunbalcı Aydın,3,0,12,10,25,
Matematik Mühendisliği,Mirsat Yeşiltepe,7,0,17,0,24,
Matematik Mühendisliği,Mert BAL,5,0,18,0,23,
Matematik Mühendisliği,Kadriye Şimşek Alan,0,1,20,0,21,
Matematik Mühendisliği,Müslüm ÖZIŞIK,0,0,3,15,18,
Matematik Mühendisliği,Nilgün GÜLER BAYAZIT,0,2,15,0,17,
Matematik Mühendisliği,Arzu TURAN DİNCEL,0,1,16,0,17,
Matematik Mühendisliği,Noyan Fevzi Er,0,0,15,2,17,
Matematik Mühendisliği,Seda GÖKTEPE KÖRPEOĞLU,0,0,15,0,15,
Matematik Mühendisliği,B. Ali IBRAHIMOGLU,0,0,14,0,14,
Matematik Mühendisliği,Fatih TAŞÇİ,0,0,14,0,14,
Matematik Mühendisliği,İbrahim Emiroğlu,0,2,8,1,11,
Matematik Mühendisliği,Tuğçem PARTAL,0,0,11,0,11,
Matematik Mühendisliği,Fatih Aylıkcı,2,1,8,0,11,
Matematik Mühendisliği,Reşat KÖŞKER,0,1,8,0,9,
Matematik Mühendisliği,Kadri Doğan,1,1,4,0,6,
Matematik Mühendisliği,NESLİHAN ÖZDEMİR,0,0,5,0,5,
Matematik Mühendisliği,KENAN YILDIRIM,0,0,4,0,4,
Matematik Mühendisliği,Ferhat ŞAH,0,0,3,0,3,
Matematik Mühendisliği,Ramazan TEKERCİOĞLU,0,0,3,0,3,
Matematik Mühendisliği,Şerife Karakaya,0,0,3,0,3,
Matematik Mühendisliği,Yasemin BAKIR,0,0,3,0,3,
Matematik Mühendisliği,Kevser (Özden) Köklü,0,0,1,0,1,
Mekatronik Mühendisliği,Vasfi Emre Ömürlü,5,16,65,10,96,
Mekatronik Mühendisliği,Erhan AKDOĞAN,5,10,47,9,71,
Mekatronik Mühendisliği,Kadir Erkan,8,8,35,2,53,
Mekatronik Mühendisliği,Cüneyt Yılmaz,8,7,28,6,49,
Mekatronik Mühendisliği,AHMET KOYUN,0,1,41,2,44,
Mekatronik Mühendisliği,M. Selçuk Arslan,5,6,30,1,42,
Mekatronik Mühendisliği,Hüseyin Üvet,0,10,31,1,42,
Mekatronik Mühendisliği,UTKU BÜYÜKŞAHİN,4,10,25,0,39,
Mekatronik Mühendisliği,Ahmet KIRLI,6,8,18,0,32,
Mekatronik Mühendisliği,Celal Sami Tüfekci,0,12,20,0,32,
Mekatronik Mühendisliği,Mehmet Emin Aktan,5,3,7,12,27,
Mekatronik Mühendisliği,Abdurrahman Yılmaz,4,0,8,14,26,
Mekatronik Mühendisliği,Barış Can Yalçın,8,0,14,2,24,
Mekatronik Mühendisliği,Mert Sever,4,0,18,2,24,
Mekatronik Mühendisliği,Deniz UZUNSOY,0,8,10,3,21,
Mekatronik Mühendisliği,Ahmet Taha Koru,10,1,5,3,19,
Mekatronik Mühendisliği,Aydın Yeşildirek,4,0,5,9,18,
Mekatronik Mühendisliği,Abdulkadir Yavuz,0,2,6,9,17,
Mekatronik Mühendisliği,Beytullah OKUR,0,3,11,1,15,
Mekatronik Mühendisliği,Mehmet İŞCAN,3,2,6,4,15,
Mekatronik Mühendisliği,Mehmet Hakan Demir,5,2,3,1,11,
Mekatronik Mühendisliği,HASAN FATİH ERTUĞRUL,0,3,8,0,11,
Mekatronik Mühendisliği,ÖMER FARUK GÜNEY,1,1,6,2,10,
Mekatronik Mühendisliği,Hatice Mercan,0,0,0,9,9,
Mekatronik Mühendisliği,Namık Zengin,5,1,3,0,9,
Mekatronik Mühendisliği,Muhammet Garip,0,1,2,5,8,
Mekatronik Mühendisliği,Başaran Bahadır Koçer,4,2,2,0,8,
Mekatronik Mühendisliği,Sadi Vural,0,0,7,0,7,
Mekatronik Mühendisliği,Faruk Yiğit,6,0,0,0,6,
Mekatronik Mühendisliği,Haydar LİVATYALI,0,1,0,5,6,
Mekatronik Mühendisliği,İsmail Yüksek,0,2,1,0,3,
Mekatronik Mühendisliği,Zeynep Ekicioğlu Küzeci,0,0,2,0,2,
Mekatronik Mühendisliği,Bahadır Coşkun,0,1,1,0,2,
Mekatronik Mühendisliği,Mehmet Kıvanç Çelik,0,1,0,0,1,
Metalurji ve Malzeme Mühendisliği,Necmettin MARAŞLI,7,39,205,7,258,
Metalurji ve Malzeme Mühendisliği,Ahmet KARAASLAN,5,26,122,9,162,
Metalurji ve Malzeme Mühendisliği,Afife Binnaz YORUÇ HAZAR,11,24,78,9,122,
Metalurji ve Malzeme Mühendisliği,Ali Erçin Ersundu,11,12,76,10,109,
Metalurji ve Malzeme Mühendisliği,Miray Çelikbilek Ersundu,15,12,66,15,108,
Metalurji ve Malzeme Mühendisliği,Cengiz Kaya,9,16,74,9,108,
Metalurji ve Malzeme Mühendisliği,Bünyamin Aksakal,3,12,81,0,96,
Metalurji ve Malzeme Mühendisliği,Müzeyyen MARŞOĞLU,0,14,72,0,86,
Metalurji ve Malzeme Mühendisliği,Adem Bakkaloğlu,4,6,66,6,82,
Metalurji ve Malzeme Mühendisliği,Oğuzhan AVCIATA,6,7,30,32,75,
Metalurji ve Malzeme Mühendisliği,Kerem Altuğ GÜLER,7,8,47,1,63,
Metalurji ve Malzeme Mühendisliği,H.Aygül Yeprem,5,9,43,0,57,
Metalurji ve Malzeme Mühendisliği,Alptekin KISASÖZ,0,5,46,0,51,
Metalurji ve Malzeme Mühendisliği,Figen Kaya,5,9,32,0,46,
Metalurji ve Malzeme Mühendisliği,Çağlar Yüksel,5,6,31,0,42,
Metalurji ve Malzeme Mühendisliği,Aylin ALTINBAY BEKEM,0,3,39,0,42,
Metalurji ve Malzeme Mühendisliği,Işıl KERTİ,0,2,38,0,40,
Metalurji ve Malzeme Mühendisliği,Hakan YILMAZER,7,1,24,8,40,
Metalurji ve Malzeme Mühendisliği,Mustafa Çiğdem,0,12,25,0,37,
Metalurji ve Malzeme Mühendisliği,nilgün kuşkonmaz,0,18,15,4,37,
Metalurji ve Malzeme Mühendisliği,Hale Yamak,11,3,14,8,36,
Metalurji ve Malzeme Mühendisliği,Sibel DAĞLILAR,0,5,27,0,32,
Metalurji ve Malzeme Mühendisliği,Cem Akça,4,4,14,9,31,
Metalurji ve Malzeme Mühendisliği,Buğra Çiçek,8,10,4,8,30,
Metalurji ve Malzeme Mühendisliği,Cansu Noberi,0,4,25,0,29,
Metalurji ve Malzeme Mühendisliği,Burak BİROL,4,5,16,3,28,
Metalurji ve Malzeme Mühendisliği,Ayfer KILIÇARSLAN,0,4,20,2,26,
Metalurji ve Malzeme Mühendisliği,Hüseyin Murat LUŞ,0,7,14,5,26,
Metalurji ve Malzeme Mühendisliği,Cemalettin Yaman,0,0,12,14,26,
Metalurji ve Malzeme Mühendisliği,Ahmet Ekerim,8,5,10,3,26,
Metalurji ve Malzeme Mühendisliği,Ahmet Sağın,0,3,15,6,24,
Metalurji ve Malzeme Mühendisliği,UTKAN ŞAHİNTÜRK,3,11,10,0,24,
Metalurji ve Malzeme Mühendisliği,Ahmet ÜNAL,0,5,15,3,23,
Metalurji ve Malzeme Mühendisliği,Nurhan Cansever,0,0,21,0,21,
Metalurji ve Malzeme Mühendisliği,Nilüfer Evcimen Duygulu,0,3,16,0,19,
Metalurji ve Malzeme Mühendisliği,Gökhan ÖZER,0,3,15,0,18,
Metalurji ve Malzeme Mühendisliği,Mustafa KOCABAŞ,4,4,10,0,18,
Metalurji ve Malzeme Mühendisliği,Rıdvan Gecü,2,1,14,0,17,
Metalurji ve Malzeme Mühendisliği,Ahmet Topuz,0,0,16,0,16,
Metalurji ve Malzeme Mühendisliği,Yaman Erarslan,0,2,14,0,16,
Metalurji ve Malzeme Mühendisliği,Oğuz Kaan ÖZDEMİR,0,5,10,0,15,
Metalurji ve Malzeme Mühendisliği,Hatice Mollaoğlu Altuner,0,4,10,0,14,
Metalurji ve Malzeme Mühendisliği,Fatih KILIÇ,0,4,7,0,11,
Metalurji ve Malzeme Mühendisliği,Erdoğdu GÜZEL,4,2,3,0,9,
Metalurji ve Malzeme Mühendisliği,Ergün Keleşoğlu,0,2,2,4,8,
Metalurji ve Malzeme Mühendisliği,zekeriya yaşar cömert,0,1,6,0,7,
Metalurji ve Malzeme Mühendisliği,Özkan Şen,0,3,3,0,6,
Metalurji ve Malzeme Mühendisliği,Özlem Uçak,0,1,4,0,5,
Metalurji ve Malzeme Mühendisliği,İrem Cemre TÜRÜ,0,0,5,0,5,
Metalurji ve Malzeme Mühendisliği,Sercan Basit,2,0,2,0,4,
Metalurji ve Malzeme Mühendisliği,Yahya Bayrak,0,1,2,0,3,
Metalurji ve Malzeme Mühendisliği,Mücahid ÖZCAN,3,0,0,0,3,
Metalurji ve Malzeme Mühendisliği,Gökhan POLAT,0,1,1,0,2,
Metalurji ve Malzeme Mühendisliği,Kübra ÖNOL,0,1,1,0,2,
Metalurji ve Malzeme Mühendisliği,Serhat Acar,0,0,2,0,2,
Milli Saraylar ve Tarihi Yapılar Meslek Yüksek Okulu,Drahşan Uğuryol,0,4,9,9,22,
Milli Saraylar ve Tarihi Yapılar Meslek Yüksek Okulu,Rabia Özakın,0,0,5,0,5,
Mimarlık,Mehmet Cengiz Can,0,4,92,102,198,
Mimarlık,Rengin ÜNVER,1,16,168,8,193,
Mimarlık,Zerhan Yüksel Can,0,9,145,11,165,
Mimarlık,Neşe Yüğrük Akdağ,3,11,76,10,100,
Mimarlık,Leyla Dokuzer Öztürk,3,8,73,0,84,
Mimarlık,Görün Arun,1,9,59,5,74,
Mimarlık,Selim Ökem,0,3,40,29,72,
Mimarlık,Ali Osman Kuruşcu,0,9,34,6,49,
Mimarlık,Zehra Canan Girgin,10,2,30,6,48,
Mimarlık,MEHMET NURİ İLGÜREL,0,1,36,9,46,
Mimarlık,Çiğdem Polatoğlu,0,5,39,0,44,
Mimarlık,kunter manisa,4,6,25,8,43,
Mimarlık,Gülay Zorer Gedik,2,10,26,4,42,
Mimarlık,M. Tolga Akbulut,0,3,27,10,40,
Mimarlık,POLAT DARÇIN,7,1,20,12,40,
Mimarlık,Selin YILDIZ,4,3,18,15,40,
Mimarlık,SERHAT BASDOĞAN,8,1,27,4,40,
Mimarlık,AYŞE BALANLI,0,1,29,9,39,
Mimarlık,Funda Kerestecioğlu Öztürk,4,3,31,1,39,
Mimarlık,Senem Kaymaz Koca,4,2,30,3,39,
Mimarlık,Ayşen Ciravoğlu,4,1,30,3,38,
Mimarlık,Alev Erkmen,1,0,10,26,37,
Mimarlık,Elifnaz Durusoy,6,0,18,13,37,
Mimarlık,ASLI SUNGUR ERGENOĞLU,7,2,22,4,35,
Mimarlık,Olcay ÇETİNER ÖZDEMİR,0,2,19,12,33,
Mimarlık,Almula Köksal Işıkkaya,0,0,26,7,33,
Mimarlık,Tuğçe ERCAN,4,0,21,8,33,
Mimarlık,Şensin Yağmur,0,2,30,0,32,
Mimarlık,uzay yergün,0,5,24,3,32,
Mimarlık,Ceylan İrem Gençer (Yaylalı),2,0,16,14,32,
Mimarlık,F. Pınar Arabacıoğlu,0,0,29,0,29,
Mimarlık,Ömür BARKUL,4,3,22,0,29,
Mimarlık,Candan Çınar,0,0,18,8,26,
Mimarlık,Esra Küçükkılıç Özcan,1,2,23,0,26,
Mimarlık,TOGAN TONG,0,1,7,17,25,
Mimarlık,Aynur Çiftçi,0,2,21,1,24,
Mimarlık,Ezgi KORKMAZ,3,1,17,3,24,
Mimarlık,Nur Umar,5,0,9,10,24,
Mimarlık,Hande DÜZGÜN BEKDAŞ,5,1,16,0,22,
Mimarlık,ZEYNEP GÜL ÜNAL,2,1,9,10,22,
Mimarlık,Füsun Çizmeci Yöreş,0,3,11,7,21,
Mimarlık,Feride ÖNAL,5,0,15,0,20,
Mimarlık,Şerife Özata,2,0,9,9,20,
Mimarlık,Seda Tönük,0,0,18,0,18,
Mimarlık,Bengi Yurtsever,3,0,15,0,18,
Mimarlık,Gökçe TUNA TAYGUN,0,2,11,4,17,
Mimarlık,Tuğrul Yazar,0,2,15,0,17,
Mimarlık,Erkan Avlar,0,0,17,0,17,
Mimarlık,Deniz ERİNSEL ÖNDER,0,0,16,0,16,
Mimarlık,Öze ULUENGİN,0,0,15,0,15,
Mimarlık,Ayten Erdem,0,0,13,2,15,
Mimarlık,Aylin Akçabozan,0,0,9,6,15,
Mimarlık,Burçin Mızrak Bilen,5,0,10,0,15,
Mimarlık,Çiğdem Canbay Türkyılmaz,0,0,13,1,14,
Mimarlık,Banu Çelebioğlu,0,0,8,6,14,
Mimarlık,S.Müjdem Vural,0,2,12,0,14,
Mimarlık,Neslinur Hızlı,2,0,11,0,13,
Mimarlık,Dilek Ekşi Akbulut,0,2,8,2,12,
Mimarlık,Deniz Tuzcuoğlu,6,0,5,0,11,
Mimarlık,Murat Soygeniş,0,0,10,0,10,
Mimarlık,Tan Kamil GÜRER,2,0,7,1,10,
Mimarlık,Yasemen SAY ÖZER,0,4,4,1,9,
Mimarlık,Işıl Çokuğraş,0,0,9,0,9,
Mimarlık,Semih Serkan Ustaoğlu,3,1,4,1,9,
Mimarlık,ZEYNEP UZUN,0,1,3,5,9,
Mimarlık,SEVGUL LİMONCU,0,0,8,0,8,
Mimarlık,M. EBRU ERDÖNMEZ,3,0,4,0,7,
Mimarlık,Seda Serbest Yenidünya,2,0,2,3,7,
Mimarlık,berrin alper,3,0,2,2,7,
Mimarlık,Nuran Kara Pilehvarian,0,0,6,0,6,
Mimarlık,Kasım Çelik,0,0,6,0,6,
Mimarlık,Berrak KIRBAŞ AKYÜREK,0,0,6,0,6,
Mimarlık,Meliha Pınar Sağıroğlu,5,0,0,0,5,
Mimarlık,ZAFER SAGDIC,0,0,4,0,4,
Mimarlık,Serkan Uysal,0,1,1,1,3,
Mimarlık,Özde Özdal,3,0,0,0,3,
Mimarlık,Ömür Kararmaz,3,0,0,0,3,
Mimarlık,mehmet zafer akdemir,0,1,1,0,2,
Mimarlık,Hasan Taştan,0,0,2,0,2,
Mimarlık,Elvan Ebru Omay Polat,0,0,0,1,1,
Mimarlık,Mustafa Esat GÜNEŞ,0,0,1,0,1,
Mimarlık,Ayfer Aytuğ,0,0,1,0,1,
Mimarlık,Havva Merve Tuncer,0,1,0,0,1,
Mimarlık,Ahmet Bircan ATMACA,1,0,0,0,1,
Mimarlık Fakültesi,Nazlı Ferah AKINCI,12,0,51,0,63,
Mimarlık Fakültesi,Jose Manuel Garcia Torres,0,0,2,6,8,
Modern Diller,Cemile Güler,5,0,2,8,15,
Modern Diller,Meryem Yeltekin Karaman,0,1,2,11,14,
Modern Diller,Hülya Polat Çakmak,0,0,0,11,11,
Modern Diller,AYTEN DAVUTOĞLU,2,0,8,1,11,
Modern Diller,ayşe zeynep kıvanç,0,0,4,6,10,
Modern Diller,Ayşe Emengen,2,0,8,0,10,
Modern Diller,Süheda Özbay,0,0,3,6,9,
Modern Diller,BURCU KAYARKAYA,4,0,0,4,8,
Modern Diller,fatih gülbakan,0,0,1,6,7,
Modern Diller,Ercan Muharrem Erkuş,1,1,0,4,6,
Modern Diller,Betül Ayanoğlu,0,1,5,0,6,
Modern Diller,Şükran DAĞ,2,0,2,0,4,
Modern Diller,SANEM PEKER,0,0,0,4,4,
Modern Diller,Sena Savur,0,0,0,4,4,
Modern Diller,SERAP KARTAL YAYLI,0,0,0,4,4,
Modern Diller,Bahar Yiğitbaş Akça,0,0,0,3,3,
Modern Diller,Melda Yalçın Bitigen,1,0,0,2,3,
Modern Diller,Fitnet YİĞİT,0,0,0,2,2,
Modern Diller,Buket Tanju,1,1,0,0,2,
Modern Diller,ilhan başaran,0,0,0,2,2,
Modern Diller,Betül Özel,0,0,0,1,1,
Modern Diller,Oya Özemir,0,0,1,0,1,
Moleküler Biyoloji ve Genetik,muhammed hamza müslümanoğlu,0,4,81,29,114,
Moleküler Biyoloji ve Genetik,Banu Mansuroğlu,0,20,56,5,81,
Moleküler Biyoloji ve Genetik,İsmail Kocaçalışkan,3,5,40,9,57,
Moleküler Biyoloji ve Genetik,Sezgin Çelik,4,4,45,0,53,
Moleküler Biyoloji ve Genetik,Zerrin Çalışkan,3,12,24,4,43,
Moleküler Biyoloji ve Genetik,Emel Ordu,3,12,26,0,41,
Moleküler Biyoloji ve Genetik,TÜLİN ARASOĞLU,3,16,13,2,34,
Moleküler Biyoloji ve Genetik,Şenay Vural Korkut,0,10,16,0,26,
Moleküler Biyoloji ve Genetik,Günseli Kurt Gür,0,7,17,0,24,
Moleküler Biyoloji ve Genetik,Esra Yüca,0,4,19,0,23,
Moleküler Biyoloji ve Genetik,Semiha ERİŞEN,2,4,7,6,19,
Moleküler Biyoloji ve Genetik,Pınar ÇAĞLAR,2,3,8,0,13,
Moleküler Biyoloji ve Genetik,Nehir Özdemir Özgentürk,0,4,6,0,10,
Moleküler Biyoloji ve Genetik,Burcu Türkoğlu,3,1,4,0,8,
Moleküler Biyoloji ve Genetik,Munise YURTSEVER,0,2,4,0,6,
Moleküler Biyoloji ve Genetik,Mine Kuçak,1,0,0,1,2,
Moleküler Biyoloji ve Genetik,Hasan DEMİRCİ,2,0,0,0,2,
Müzik ve Sahne Sanatları,EVREN BİLGE KUTLAY,3,0,20,19,42,
Müzik ve Sahne Sanatları,Aslıhan Eruzun Özel,6,1,8,17,32,
Müzik ve Sahne Sanatları,TAN TEMEL,14,5,8,0,27,
Müzik ve Sahne Sanatları,Gürsel Yurtseven,2,1,20,0,23,
Müzik ve Sahne Sanatları,Cemalettin Bülent Ergüden,2,0,11,9,22,
Müzik ve Sahne Sanatları,GÜNSU YILMA,3,3,13,0,19,
Müzik ve Sahne Sanatları,SERNAZ DEMİREL TEMEL,7,4,8,0,19,
Müzik ve Sahne Sanatları,Ayrin Ersöz,7,2,4,0,13,
Müzik ve Sahne Sanatları,Nesibe Özgül Turgay,0,1,10,0,11,
Müzik ve Sahne Sanatları,Esra Berkman,0,2,7,0,9,
Müzik ve Sahne Sanatları,UĞUR GÜLBAHARLI,0,0,0,8,8,
Müzik ve Sahne Sanatları,Özer Özel,2,1,0,4,7,
Müzik ve Sahne Sanatları,OSMAN HALİL İMİK,1,3,3,0,7,
Müzik ve Sahne Sanatları,Tolga ÜNALDI,5,0,0,0,5,
Müzik ve Sahne Sanatları,Koray SAZLI,1,1,2,0,4,
Müzik ve Sahne Sanatları,Zeynep Gülçin Özkişi,0,0,3,0,3,
Müzik ve Sahne Sanatları,EMİNE CEYLAN ÜNAL AKBULUT,1,0,0,2,3,
Müzik ve Sahne Sanatları,Ece Merve Yüceer,1,0,2,0,3,
Müzik ve Sahne Sanatları,Eylem Arıca,0,0,2,0,2,
Müzik ve Sahne Sanatları,Arda Eden,1,0,1,0,2,
,Kâmil VARINCA,0,4,47,0,51,
,Erdem Uzunsoy,1,1,12,6,20,
,ibrahim YILDIZ,0,2,14,0,16,
,Burhan Celil IŞIK,0,0,0,13,13,
,Aysu Aydınoğlu,0,2,2,0,4,
,Mustafa ALIŞVERİŞÇİ,0,0,1,2,3,
,Tamer Yılmaz,0,0,2,0,2,
,Evren Cesur,0,2,0,0,2,
,Mesut Ülen,0,0,1,0,1,
,,0,1,0,0,1,
,Mustafa Kemal Sevindir,0,0,1,0,1,
,,0,0,1,0,1,
Rektörlük,Melisa TÜRKOĞLU LAÇİN,3,6,22,3,34,
Rektörlük,Ali Can Zaman,5,4,9,0,18,
Rektörlük,Dilek İlhan,7,0,9,0,16,
Rektörlük,Fatma ÇOBAN,3,7,5,0,15,
Rektörlük,Habibe Akçay,0,0,10,0,10,
Rektörlük,İLKAY ŞENEL,0,1,8,0,9,
Rektörlük,Fuat Fındıkoğlu,0,0,8,0,8,
Rektörlük,Emel Ulukaya,3,1,2,0,6,
Rektörlük,Işıl Dönümcü,3,0,3,0,6,
Rektörlük,Öznur Engin,0,0,4,0,4,
Rektörlük,Fethi Murat Doğan,0,0,0,2,2,
Rektörlük,ARMAĞAN BAKILI AKKOÇ,2,0,0,0,2,
Rektörlük,Nurdan YILDIZ GÜNDÜZ,0,1,0,0,1,
Rektörlük,Fatma KARACA,0,0,1,0,1,
Rektörlük,Tolga Saim BAŞÇETİN,0,0,1,0,1,
Rektörlük,BEGÜM EFE,0,0,1,0,1,
Rektörlük,Beril Gümüş,0,0,1,0,1,
Sanat,Kadriye Tezcan Akmehmet,4,4,34,27,69,
Sanat,Mehmet Emin KAHRAMAN,5,4,29,30,68,
Sanat,Seza Sinanlar Uslu,5,4,30,13,52,
Sanat,Emine ÖNEL KURT,8,2,16,19,45,
Sanat,Zerrin İren Boynudelik,0,2,35,7,44,
Sanat,İSMAİL COŞKUN,2,1,24,15,42,
Sanat,Hale ÖZKASIM,4,2,9,23,38,
Sanat,Bahadır Uçan,4,5,21,1,31,
Sanat,Burak Boyraz,4,3,18,5,30,
Sanat,MEHMET NUHOĞLU,1,1,10,16,28,
Sanat,Uğur Kutay,0,0,9,16,25,
Sanat,Ozan Yavuz,5,4,15,0,24,
Sanat,Kemal Gök,0,18,5,0,23,
Sanat,İbrahim O. AKINCI,3,3,8,8,22,
Sanat,Saliha Nesli GÜL DURUKAN,4,6,12,0,22,
Sanat,Nevin Çakmakoğlu,2,1,4,14,21,
Sanat,ERKAN ÇİÇEK,3,1,14,0,18,
Sanat,Burcu Böcekler,3,1,13,0,17,
Sanat,Ahmet DOLUNAY,2,1,5,7,15,
Sanat,CELAL ESER,3,0,0,12,15,
Sanat,Tuğba RENKÇİ TAŞTAN,2,1,11,0,14,
Sanat,Dilek Türkmenoğlu,0,0,11,0,11,
Sanat,Mehmet Şah Maltaş,1,0,0,5,6,
Sanat,Metin Çavuş,0,1,3,0,4,
Sanat,Züleyha Altıntaş,0,1,3,0,4,
Sanat,Ayça Tufan,0,0,2,0,2,
Sanat,muammer bozkurt,0,0,0,1,1,
Sanat,Emrah Günay,1,0,0,0,1,
Sanat ve Tasarım,Rifat Şahiner,2,0,11,25,38,
Sanat ve Tasarım,Şenol Küçükyıldırım,0,0,0,7,7,
Sanat ve Tasarım Fakültesi,Turan Sağer,1,16,31,2,50,
Sanat ve Tasarım Fakültesi,Ahmet ATAN,0,16,8,3,27,
Sanat ve Tasarım Fakültesi,İlhan ÖZKEÇECİ,0,2,13,4,19,
Sanat ve Tasarım Fakültesi,Mustafa Kemal Karaosmanoğlu,3,2,6,2,13,
Sanat ve Tasarım Fakültesi,Ufuk M. DUYGUN,0,0,1,10,11,
Sanat ve Tasarım Fakültesi,ALPER Maral,4,0,7,0,11,
Sanat ve Tasarım Fakültesi,Ahmet Ziya SANDIKCIOĞLU,0,0,1,4,5,
Sanat ve Tasarım Fakültesi,Nur Cemelelioğlu Altın,4,0,0,0,4,
Siyaset Bilimi ve Uluslararası İlişkiler,Mehmet Hacısalihoğlu,3,3,58,10,74,
Siyaset Bilimi ve Uluslararası İlişkiler,Ömer Çaha,1,6,50,4,61,
Siyaset Bilimi ve Uluslararası İlişkiler,Esra Danacıoğlu Tamur,0,7,39,7,53,
Siyaset Bilimi ve Uluslararası İlişkiler,Elçin Macar,3,0,48,0,51,
Siyaset Bilimi ve Uluslararası İlişkiler,Evren Balta,1,4,35,5,45,
Siyaset Bilimi ve Uluslararası İlişkiler,Çiğdem Nas,0,9,23,3,35,
Siyaset Bilimi ve Uluslararası İlişkiler,Fuat Aksu,6,4,15,6,31,
Siyaset Bilimi ve Uluslararası İlişkiler,Ali Rıza Büyükuslu,6,1,21,1,29,
Siyaset Bilimi ve Uluslararası İlişkiler,Zeynep Özden oktav,0,5,15,7,27,
Siyaset Bilimi ve Uluslararası İlişkiler,Helin Sarı Ertem,0,1,19,0,20,
Siyaset Bilimi ve Uluslararası İlişkiler,Yetkin Başkavak,3,0,13,0,16,
Siyaset Bilimi ve Uluslararası İlişkiler,Elif Bali Kurtarır,5,0,10,0,15,
Siyaset Bilimi ve Uluslararası İlişkiler,Gökhan Demir,0,1,13,0,14,
Siyaset Bilimi ve Uluslararası İlişkiler,Ozan Erözden,0,1,12,0,13,
Siyaset Bilimi ve Uluslararası İlişkiler,HALDUN GÜLALP,0,0,13,0,13,
Siyaset Bilimi ve Uluslararası İlişkiler,Laçin İdil Oztığ,4,1,7,0,12,
Siyaset Bilimi ve Uluslararası İlişkiler,ester ruben,0,0,11,0,11,
Siyaset Bilimi ve Uluslararası İlişkiler,ASLI DALDAL,0,0,8,0,8,
Siyaset Bilimi ve Uluslararası İlişkiler,Muhammed Agcan,0,1,7,0,8,
Siyaset Bilimi ve Uluslararası İlişkiler,nursin ateşoğlu güney,0,1,6,0,7,
Siyaset Bilimi ve Uluslararası İlişkiler,Visne Korkmaz,0,1,3,0,4,
Siyaset Bilimi ve Uluslararası İlişkiler,Özden Zeynep oktav,3,0,0,1,4,
Siyaset Bilimi ve Uluslararası İlişkiler,cengiz çağla,0,0,3,0,3,
Siyaset Bilimi ve Uluslararası İlişkiler,Ferda FAHRİOĞLU AKIN,2,0,0,0,2,
Siyaset Bilimi ve Uluslararası İlişkiler,Ahmet Conker,2,0,0,0,2,
Sosyal Bilimler Enstitüsü,Hülya Cengiz,1,0,9,0,10,
Sosyal Bilimler Enstitüsü,Nermin Banu Süer,0,0,3,0,3,
Sosyoloji,Şerif Esendemir,7,0,42,14,63,
Sosyoloji,Onur Güneş Ayas,5,0,37,0,42,
Sosyoloji,Ergün Yıldırım,0,0,19,0,19,
Sosyoloji,Kadir Canatan,0,1,12,0,13,
Sosyoloji,Bedri Gencer,0,0,8,0,8,
Tarih,Turhan Ada,4,1,29,54,88,
Teknik Programlar,Petek Ayda Ustaömer,1,9,53,1,64,
Teknik Programlar,KAMELYA KAVAKLI TANSEL,0,0,4,44,48,
Teknik Programlar,burak satar,5,6,2,24,37,
Teknik Programlar,Mehmet Fevzi Uğuryol,0,4,19,11,34,
Teknik Programlar,MEHMET EREN,0,0,0,22,22,
Teknik Programlar,Namık Kutlu,0,0,0,20,20,
Teknik Programlar,ÇAĞRI ARIKAN,0,0,18,0,18,
Teknik Programlar,Timur Akçalı,0,0,8,5,13,
Teknik Programlar,Taylan Engin,0,7,5,0,12,
Teknik Programlar,Muharrem Hilmi Erkoç,0,1,3,8,12,
Teknik Programlar,YAVUZ SEVİNÇ,0,0,0,11,11,
Teknik Programlar,RABİA ÖZAKIN,0,1,8,0,9,
Teknik Programlar,Muhammet TORAMAN,2,2,5,0,9,
Teknik Programlar,hüseyin k. ceylan,0,0,0,8,8,
Teknik Programlar,Ömer ŞAHİN,0,0,0,8,8,
Teknik Programlar,Esra Bacaksiz,0,0,0,7,7,
Teknik Programlar,Cengiz Can,0,2,5,0,7,
Teknik Programlar,ali murat silpagar,0,0,0,6,6,
Teknik Programlar,Nefise Burcu Yağan,0,2,0,0,2,
Teknik Programlar,AYÇA ÖZMEN,0,0,2,0,2,
Teknik Programlar,S. Oğuz Selvi,0,0,0,2,2,
Teknik Programlar,Umut Akyüz,0,0,1,0,1,
Temel İngilizce,Kaine Gülözer,5,1,11,15,32,
Temel İngilizce,Sevcan Yılmaz Kutlay,3,0,20,4,27,
Temel İngilizce,"Aylin (YAVAŞ) AKINLAR, PhDc",6,1,6,3,16,
Temel İngilizce,Asena KAYA,10,0,3,0,13,
Temel İngilizce,Uğur Akpur,5,0,7,0,12,
Temel İngilizce,Arzu Ekoç,5,0,5,1,11,
Temel İngilizce,Didem Tuğçe Erdem Büyükgökçesu,4,4,3,0,11,
Temel İngilizce,Emre Erbatur,0,0,10,0,10,
Temel İngilizce,Pınar Kocabaş Gedik,2,0,5,0,7,
Temel İngilizce,Mehmet GEZER,5,0,1,0,6,
Temel İngilizce,Merve Bako,3,0,2,1,6,
Temel İngilizce,Pınar Tekin,3,0,2,0,5,
Temel İngilizce,Yeliz Yılmaz,4,0,0,0,4,
Temel İngilizce,Pinar Aytekin Özkan,0,0,4,0,4,
Temel İngilizce,AYŞEGÜL OKAY,4,0,0,0,4,
Temel İngilizce,Ayşe Özkan,1,0,2,0,3,
Temel İngilizce,nil esra başaran,0,0,1,1,2,
Temel İngilizce,Filiz Çoban,1,0,0,0,1,
Temel İngilizce,Esin Aydoğdu,0,0,1,0,1,
Temel İngilizce,Doğa Bilginer,0,0,1,0,1,
Temel İngilizce,Ayşegül Şenyiğit,0,0,0,1,1,
Temel İngilizce,TUĞBA YAVUZİŞ,0,0,1,0,1,
Temel İngilizce,Neslihan Kabaklı,0,0,1,0,1,
Temel İngilizce,Duygu Özbilen,0,0,1,0,1,
Temel İngilizce,Ezgi Aydemir,0,0,1,0,1,
Temel İngilizce,Tanju Sarı,0,0,1,0,1,
Türk Dili,Nurgül Karayazı,0,1,9,0,10,
Türk Dili,Cemile İnan,0,0,0,4,4,
Türk Dili,Hilal Tufan,0,0,0,2,2,
Türk Dili,Ayşe Serpil Baytaş,0,0,0,2,2,
Türk Dili,Arzuhan Kocabaş,0,0,0,1,1,
Türk Dili ve Edebiyatı,Yakup Çelik,0,4,67,0,71,
Türk Dili ve Edebiyatı,Ayşe Melek ÖZYETGİN,3,3,56,5,67,
Türk Dili ve Edebiyatı,cihan okuyucu,0,2,57,0,59,
Türk Dili ve Edebiyatı,Aynur KOÇAK,0,0,56,0,56,
Türk Dili ve Edebiyatı,Nihayet Arslan,0,1,23,20,44,
Türk Dili ve Edebiyatı,Ali Yıldız,1,0,32,0,33,
Türk Dili ve Edebiyatı,Sevim Yılmaz Önder,10,3,12,7,32,
Türk Dili ve Edebiyatı,Didem Ardalı Büyükarman,1,3,14,1,19,
Türk Dili ve Edebiyatı,Mehmet OLMEZ,0,0,18,0,18,
Türk Dili ve Edebiyatı,İbrahim Sona,2,2,12,0,16,
Türk Dili ve Edebiyatı,BÜŞRA SÜRGİT,6,0,7,0,13,
Türk Dili ve Edebiyatı,Alparslan Oymak,0,1,10,0,11,
Türk Dili ve Edebiyatı,FUNDA ŞAN,0,0,10,0,10,
Türk Dili ve Edebiyatı,Betül Özbay,3,0,3,0,6,
Türk Dili ve Edebiyatı,Fikret Yıldırım,0,0,4,0,4,
Türk Dili ve Edebiyatı,Esengül Sağlam,3,1,0,0,4,
Türk Dili ve Edebiyatı,Zuhal Ölmez,0,0,3,0,3,
Türk Dili ve Edebiyatı,Özlem Ayazlı,0,0,2,0,2,
Türk Dili ve Edebiyatı,Fatma Zehra Uğurcan,1,0,1,0,2,
Türk Dili ve Edebiyatı,Banu Öztürk,0,1,0,0,1,
Türk Dili ve Edebiyatı,Uğur Uzunkaya,1,0,0,0,1,
Türk Dili ve Edebiyatı,Zeynep Pınar Can,1,0,0,0,1,
Türk Dili ve Edebiyatı,Hicran Yücel,1,0,0,0,1,
Türkçe Eğitimi,Sezai Coşkun,0,0,113,1,114,
Türkçe Eğitimi,BAYRAM BAŞ,4,2,54,11,71,
Türkçe Eğitimi,Ali Fuat Arıcı,5,1,58,0,64,
Türkçe Eğitimi,Neslihan KARAKUŞ,4,0,50,5,59,
Türkçe Eğitimi,Talat AYTAN,0,4,52,0,56,
Türkçe Eğitimi,Hasan Mesut Meral,6,0,35,4,45,
Türkçe Eğitimi,Hayrullah KAHYA,6,1,25,12,44,
Türkçe Eğitimi,Muhammed Eyyüp Sallabaş,5,1,11,0,17,
Türkçe Eğitimi,Durmuş Barış KIR,1,0,2,0,3,
Türkçe Eğitimi,Selim TİRYAKİOL,0,0,2,0,2,
Yabancı Diller Eğitimi,H. Gülru Yüksel,3,4,55,8,70,
Yabancı Diller Eğitimi,Ahmet Başal,8,5,47,5,65,
Yabancı Diller Eğitimi,celile eren argıt,4,4,35,13,56,
Yabancı Diller Eğitimi,Emrah Özcan,3,0,27,12,42,
Yabancı Diller Eğitimi,Suzan Kavanoz,0,4,38,0,42,
Yabancı Diller Eğitimi,ferda ilerten,1,0,10,29,40,
Yabancı Diller Eğitimi,Burcu Varol,2,0,11,12,25,
Yabancı Diller Eğitimi,B. Arif Güleç,0,0,4,18,22,
Yabancı Diller Eğitimi,Gülümser Efeoğlu,0,2,12,0,14,
Yabancı Diller Eğitimi,Elif KIR,0,1,7,0,8,
Yabancı Diller Eğitimi,Kıymet Merve Celen,0,1,7,0,8,
Yabancı Diller Eğitimi,Aslı Başdoğan,7,0,0,0,7,
Yabancı Diller Eğitimi,Selahattin Yılmaz,0,0,6,0,6,
Yabancı Diller Eğitimi,Duygu Çandarlı,0,0,4,0,4,
Yabancı Diller Eğitimi,Isil Boy Ergül,2,0,2,0,4,
Yabancı Diller Eğitimi,Janet Ekstract,0,1,0,0,1,
Yabancı Diller Yüksek Okulu,Nihal Yurtseven,5,0,15,0,20,
Yabancı Diller Yüksek Okulu,Angelica Fulga,4,0,5,0,9,
Yabancı Diller Yüksek Okulu,Onur Uludağ,4,0,3,0,7,
Yabancı Diller Yüksek Okulu,Selver Uslu-Serbest,5,0,1,0,6,
Yabancı Diller Yüksek Okulu,Ebru OSBORNE,5,0,0,0,5,
Yabancı Diller Yüksek Okulu,Talha Ağyar Altunay,0,0,1,0,1,
Yabancı Diller Yüksek Okulu,Özgür DİRİK,0,1,0,0,1,
Yabancı Diller Yüksek Okulu,Sibel Ergün Elverici,0,0,1,0,1,
Yabancı Diller Yüksek Okulu,Esra Uskan,0,0,1,0,1,
Yabancı Diller Yüksek Okulu,Tülay Vural,1,0,0,0,1,
Çevre Mühendisliği,Özer ÇINAR,12,15,148,4,179,
Çevre Mühendisliği,Ahmet Demir,2,22,143,0,167,
Çevre Mühendisliği,Mehmet Sinan Bilgili,5,33,118,0,156,
Çevre Mühendisliği,Kaan YETİLMEZSOY,21,10,107,13,151,
Çevre Mühendisliği,Bestami Özkaya,5,31,98,0,134,
Çevre Mühendisliği,Güleda Engin,7,21,67,8,103,
Çevre Mühendisliği,Süleyman ŞAKAR,0,8,76,6,90,
Çevre Mühendisliği,ÖMER APAYDIN,2,9,51,20,82,
Çevre Mühendisliği,Mehmet ÇAKMAKCI,3,18,50,11,82,
Çevre Mühendisliği,Gamze Varank,2,11,51,11,75,
Çevre Mühendisliği,Mustafa Talha GÖNÜLLÜ,0,19,55,0,74,
Çevre Mühendisliği,Eyüp Debik,5,8,54,6,73,
Çevre Mühendisliği,Bülent İlhan GONCALOĞLU,3,7,31,29,70,
Çevre Mühendisliği,Doğan Karadağ,3,18,48,0,69,
Çevre Mühendisliği,Uğur KURT,7,8,42,10,67,
Çevre Mühendisliği,ERTAN ARSLANKAYA,5,3,51,5,64,
Çevre Mühendisliği,Fatma İlter TÜRKDOĞAN,5,12,41,4,62,
Çevre Mühendisliği,Selami DEMİR,8,7,38,6,59,
Çevre Mühendisliği,Ebru AKKAYA,2,11,37,7,57,
Çevre Mühendisliği,Arslan SARAL,4,4,40,6,54,
Çevre Mühendisliği,Fatih İLHAN,6,8,28,11,53,
Çevre Mühendisliği,Sadullah Levent Kuzu,5,7,38,0,50,
Çevre Mühendisliği,Yaşar Nuhoğlu,4,5,30,7,46,
Çevre Mühendisliği,Hürrem BAYHAN,0,5,33,5,43,
Çevre Mühendisliği,Yaşar Avşar,5,11,21,5,42,
Çevre Mühendisliği,Elif Sekman,0,10,30,0,40,
Çevre Mühendisliği,Selin TOP,0,9,31,0,40,
Çevre Mühendisliği,Neslihan Manav Demir,3,8,25,4,40,
Çevre Mühendisliği,Mahir İNCE,6,12,15,5,38,
Çevre Mühendisliği,Gürdal Kanat,2,9,18,8,37,
Çevre Mühendisliği,Gökhan Önder Ergüven,6,6,24,0,36,
Çevre Mühendisliği,Emel KOÇAK,3,7,21,2,33,
Çevre Mühendisliği,Emre Oğuz KÖROĞLU,5,7,20,1,33,
Çevre Mühendisliği,Kübra Altuntaş,7,2,16,4,29,
Çevre Mühendisliği,Afşın Yusuf ÇETİNKAYA,4,7,15,3,29,
Çevre Mühendisliği,Senem YAZICI GÜVENÇ,0,4,24,0,28,
Çevre Mühendisliği,Elanur ADAR,5,5,10,8,28,
Çevre Mühendisliği,Hanife Sarı Erkan,4,4,19,0,27,
Çevre Mühendisliği,Fatma Büşra YAMAN,0,6,18,1,25,
Çevre Mühendisliği,BAHAR İKİZOĞLU,0,4,20,0,24,
Çevre Mühendisliği,Gülizar KURTOĞLU AKKAYA,4,5,10,0,19,
Çevre Mühendisliği,Sevgi Güneş Durak,5,2,10,0,17,
Çevre Mühendisliği,Aykut Karadeniz,3,4,9,0,16,
Çevre Mühendisliği,Gamze DALGIÇ,0,7,9,0,16,
Çevre Mühendisliği,Harun ELCİK,0,5,8,0,13,
Çevre Mühendisliği,Halil İbrahim UZUN,0,1,4,0,5,
Çevre Mühendisliği,Hülya CİVELEK YÖRÜKLÜ,3,2,0,0,5,
Çevre Mühendisliği,Beyza Üstün,0,1,3,0,4,
Çevre Mühendisliği,Abdulkadir ÇAĞLAK,2,0,1,0,3,
Çevre Mühendisliği,Havva Melda AKBİN,0,1,0,0,1,
Şehir ve Bölge Planlama,Asuman Türkün,3,4,101,7,115,
Şehir ve Bölge Planlama,MUSTAFA VAR,1,86,13,0,100,
Şehir ve Bölge Planlama,Hülya Berkmen,3,3,54,12,72,
Şehir ve Bölge Planlama,B. Ayşegül Özbakır,12,8,29,16,65,
Şehir ve Bölge Planlama,iclal sema dinçer,3,8,49,4,64,
Şehir ve Bölge Planlama,Senay Oğuztimur,3,6,39,4,52,
Şehir ve Bölge Planlama,Erhan KURTARIR,8,4,22,9,43,
Şehir ve Bölge Planlama,ESİN ÖZLEM AKTUĞLU AKTAN,4,2,28,3,37,
Şehir ve Bölge Planlama,Nazire Diker,3,2,26,6,37,
Şehir ve Bölge Planlama,Sırma Ramazanoğulları TURGUT,8,4,24,0,36,
Şehir ve Bölge Planlama,Zeynep Enlil,2,10,20,1,33,
Şehir ve Bölge Planlama,Bora YERLİYURT,4,9,17,2,32,
Şehir ve Bölge Planlama,Yiğit Evren,4,1,24,0,29,
Şehir ve Bölge Planlama,Nilgün Çolpan Erkan,2,4,20,1,27,
Şehir ve Bölge Planlama,Ebru Seçkin,4,3,14,2,23,
Şehir ve Bölge Planlama,Mehmet Doruk Özügül,0,2,17,3,22,
Şehir ve Bölge Planlama,Oya Akın,0,1,17,3,21,
Şehir ve Bölge Planlama,Töre Seçilmişler,1,1,12,0,14,
Şehir ve Bölge Planlama,Darçın Akın,0,2,7,5,14,
Şehir ve Bölge Planlama,AYLİN ŞENTÜRK,5,0,7,0,12,
Şehir ve Bölge Planlama,Adem SAKARYA,0,0,11,0,11,
Şehir ve Bölge Planlama,Senem Kozaman,5,1,0,4,10,
Şehir ve Bölge Planlama,tolga islam,0,0,9,1,10,
Şehir ve Bölge Planlama,Ayse Nur Ökten,0,0,8,1,9,
Şehir ve Bölge Planlama,Çiğdem Buyrukçu İbişoğlu,5,1,2,0,8,
Şehir ve Bölge Planlama,Tülay AYAŞLIGİL,0,0,1,6,7,
Şehir ve Bölge Planlama,Gözdem Çelikkanat Aysu,0,0,6,1,7,
Şehir ve Bölge Planlama,hüseyin cengiz,0,0,6,0,6,
Şehir ve Bölge Planlama,Elif Kırpık,5,0,1,0,6,
Şehir ve Bölge Planlama,Gül Tüzün,0,0,0,4,4,
Şehir ve Bölge Planlama,Cenk Hamacıoğlu,0,0,3,1,4,
Şehir ve Bölge Planlama,Kerem Ekinci,0,0,4,0,4,
Şehir ve Bölge Planlama,Ayfer Yazgan,3,0,1,0,4,
Şehir ve Bölge Planlama,Tuğba Tuncer,2,0,0,0,2,
Şehir ve Bölge Planlama,Elif Örnek Özden,0,0,1,0,1,
Şehir ve Bölge Planlama,Burcu Can Çetin,0,1,0,0,1,
Şehir ve Bölge Planlama,AHMET SIVAR ASLAN,0,0,1,0,1,
